"Match Id","Series Id","Event Name","Map Name","Team 1 Id","Team 1 Name","Team 2 Id","Team 2 Name","Attacking First Team Number","Team 1 Score","Team 2 Score","Team 1 Score At Half","Team 2 Score At Half","Team 1 Pistol Wins","Team 1 Attacking Pistol Wins","Team 1 Defending Pistol Wins","Team 1 Attacking Wins","Team 1 Attacking Losses","Team 1 Defending Wins","Team 1 Defending Losses","Team 2 Pistol Wins","Team 2 Attacking Pistol Wins","Team 2 Defending Pistol Wins","Team 2 Attacking Wins","Team 2 Attacking Losses","Team 2 Defending Wins","Team 2 Defending Losses","Win Condition","Date","Team 1 Player Ids","Team 2 Player Ids","Team 1 Agents","Team 2 Agents","Total Count"
79336,35364,"VALORANT Champions 2022 - Playoffs","Haven",6344,"LOUD",6426,"OpTic Gaming",2,13,5,7,5,2,1,1,6,0,7,5,0,0,0,5,7,0,6,"standard","2022-09-18T00:00:00.000Z","[2895,4748,6037,4746,2294]","[2841,3211,398,2716,2483]","Breach,Raze,Omen,Chamber,Fade","Killjoy,Phoenix,Omen,Chamber,Fade",1588
79335,35364,"VALORANT Champions 2022 - Playoffs","Breeze",6344,"LOUD",6426,"OpTic Gaming",1,16,14,6,6,1,0,1,8,7,8,7,1,0,1,7,8,7,8,"standard","2022-09-18T00:00:00.000Z","[4746,2294,6037,4748,2895]","[2483,2841,3211,398,2716]","Cypher,Sova,Viper,Jett,KAY/O","Sova,Viper,Jett,KAY/O,Chamber",1588
79334,35364,"VALORANT Champions 2022 - Playoffs","Bind",6344,"LOUD",6426,"OpTic Gaming",2,6,13,2,10,1,1,0,4,3,2,10,1,1,0,10,2,3,4,"standard","2022-09-18T00:00:00.000Z","[4748,4746,6037,2895,2294]","[3211,2841,398,2483,2716]","Raze,Viper,Brimstone,Skye,Fade","Raze,Viper,Brimstone,Skye,Chamber",1588
79333,35364,"VALORANT Champions 2022 - Playoffs","Ascent",6344,"LOUD",6426,"OpTic Gaming",1,15,13,5,7,1,1,0,7,7,8,6,1,1,0,6,8,7,7,"standard","2022-09-18T00:00:00.000Z","[2294,4746,6037,4748,2895]","[2483,2841,398,2716,3211]","Sova,Killjoy,Omen,Jett,KAY/O","Sova,Killjoy,Omen,Jett,KAY/O",1588
79342,35365,"VALORANT Champions 2022 - Playoffs","Haven",6426,"OpTic Gaming",286,"DRX",2,13,10,8,4,1,0,1,5,6,8,4,1,0,1,4,8,6,5,"standard","2022-09-17T00:00:00.000Z","[2841,3211,398,2716,2483]","[582,1550,452,1251,814]","Killjoy,Phoenix,Omen,Chamber,Fade","Breach,Killjoy,Omen,Jett,Fade",1588
79341,35365,"VALORANT Champions 2022 - Playoffs","Ascent",6426,"OpTic Gaming",286,"DRX",2,6,13,3,9,0,0,0,3,4,3,9,2,1,1,9,3,4,3,"standard","2022-09-17T00:00:00.000Z","[2483,2841,398,2716,3211]","[814,1251,452,1550,582]","Sova,Killjoy,Omen,Jett,KAY/O","Sova,Jett,Astra,KAY/O,Fade",1588
79340,35365,"VALORANT Champions 2022 - Playoffs","Fracture",6426,"OpTic Gaming",286,"DRX",2,8,13,5,7,1,1,0,3,6,5,7,1,1,0,7,5,6,3,"standard","2022-09-17T00:00:00.000Z","[2841,398,2483,2716,3211]","[582,452,1251,1550,814]","Breach,Brimstone,KAY/O,Chamber,Neon","Breach,Brimstone,Chamber,Neon,Fade",1588
79339,35365,"VALORANT Champions 2022 - Playoffs","Breeze",6426,"OpTic Gaming",286,"DRX",2,13,5,8,4,2,1,1,5,1,8,4,0,0,0,4,8,1,5,"standard","2022-09-17T00:00:00.000Z","[2483,2841,3211,398,2716]","[814,452,1251,582,1550]","Sova,Viper,Jett,KAY/O,Chamber","Sova,Viper,Jett,Skye,Chamber",1588
79338,35365,"VALORANT Champions 2022 - Playoffs","Bind",6426,"OpTic Gaming",286,"DRX",1,13,8,7,5,0,0,0,7,5,6,3,2,1,1,3,6,5,7,"standard","2022-09-17T00:00:00.000Z","[3211,2841,398,2483,2716]","[1251,452,582,1550,814]","Raze,Viper,Brimstone,Skye,Chamber","Raze,Viper,Skye,Astra,Fade",1588
79259,35331,"VALORANT Champions 2022 - Playoffs","Haven",17,"FunPlus Phoenix",286,"DRX",2,9,13,9,3,1,0,1,0,10,9,3,1,0,1,3,9,10,0,"standard","2022-09-16T00:00:00.000Z","[1256,2359,2225,2335,3043]","[582,1550,452,1251,814]","Raze,Sova,Viper,Omen,Chamber","Breach,Killjoy,Omen,Jett,Fade",1588
79258,35331,"VALORANT Champions 2022 - Playoffs","Icebox",17,"FunPlus Phoenix",286,"DRX",2,11,13,5,7,2,1,1,6,6,5,7,0,0,0,7,5,6,6,"standard","2022-09-16T00:00:00.000Z","[1256,2225,2359,3043,2335]","[452,582,1550,1251,814]","Raze,Viper,Sage,Chamber,Fade","Viper,Sage,KAY/O,Chamber,Fade",1588
79203,35313,"VALORANT Champions 2022 - Playoffs","Ascent",6344,"LOUD",6426,"OpTic Gaming",1,13,3,9,3,2,1,1,9,3,4,0,0,0,0,0,4,3,9,"standard","2022-09-16T00:00:00.000Z","[2294,4746,6037,4748,2895]","[2483,398,3211,2716,2841]","Sova,Killjoy,Omen,Jett,KAY/O","Sova,Astra,KAY/O,Chamber,Fade",1588
79202,35313,"VALORANT Champions 2022 - Playoffs","Bind",6344,"LOUD",6426,"OpTic Gaming",2,13,10,6,6,1,1,0,7,4,6,6,1,1,0,6,6,4,7,"standard","2022-09-16T00:00:00.000Z","[4748,4746,6037,2895,2294]","[3211,2841,398,2483,2716]","Raze,Viper,Brimstone,Skye,Fade","Raze,Viper,Brimstone,Skye,Chamber",1588
79263,35332,"VALORANT Champions 2022 - Playoffs","Ascent",603,"XSET",17,"FunPlus Phoenix",2,14,16,11,1,1,0,1,3,12,11,4,1,0,1,4,11,12,3,"standard","2022-09-13T00:00:00.000Z","[3582,3062,3346,1802,494]","[2225,2335,3043,1256,2359]","Sova,Killjoy,Omen,Jett,KAY/O","Sage,Omen,Jett,KAY/O,Fade",1588
79262,35332,"VALORANT Champions 2022 - Playoffs","Bind",603,"XSET",17,"FunPlus Phoenix",2,10,13,5,7,1,0,1,5,6,5,7,1,0,1,7,5,6,5,"standard","2022-09-13T00:00:00.000Z","[3582,3062,3346,494,1802]","[1256,2225,2335,3043,2359]","Raze,Viper,Skye,Astra,Chamber","Raze,Viper,Brimstone,KAY/O,Fade",1588
79261,35332,"VALORANT Champions 2022 - Playoffs","Pearl",603,"XSET",17,"FunPlus Phoenix",1,13,11,5,7,1,1,0,5,7,8,4,1,1,0,4,8,7,5,"standard","2022-09-13T00:00:00.000Z","[3062,494,1802,3582,3346]","[2225,1256,2359,2335,3043]","Astra,KAY/O,Chamber,Neon,Fade","Sage,Skye,Astra,KAY/O,Chamber",1588
79192,35309,"VALORANT Champions 2022 - Playoffs","Fracture",286,"DRX",1625,"FNATIC",2,13,9,6,6,2,1,1,7,3,6,6,0,0,0,6,6,3,7,"standard","2022-09-13T00:00:00.000Z","[582,452,1251,1550,814]","[718,2011,76,2937,14543]","Breach,Brimstone,Chamber,Neon,Fade","Breach,Brimstone,KAY/O,Chamber,Neon",1588
79191,35309,"VALORANT Champions 2022 - Playoffs","Ascent",286,"DRX",1625,"FNATIC",1,14,12,4,8,2,1,1,5,8,9,4,0,0,0,4,9,8,5,"standard","2022-09-13T00:00:00.000Z","[814,1251,452,1550,582]","[14543,2011,2937,76,718]","Sova,Jett,Astra,KAY/O,Fade","Killjoy,Omen,Jett,KAY/O,Fade",1588
79190,35309,"VALORANT Champions 2022 - Playoffs","Icebox",286,"DRX",1625,"FNATIC",2,7,13,5,7,0,0,0,2,6,5,7,2,1,1,7,5,6,2,"standard","2022-09-13T00:00:00.000Z","[814,1550,452,582,1251]","[718,14543,2011,76,2937]","Sova,Killjoy,Viper,Sage,Jett","Sova,Killjoy,Viper,Sage,Chamber",1588
79081,35252,"VALORANT Champions 2022 - Playoffs","Pearl",6426,"OpTic Gaming",603,"XSET",1,13,8,8,4,0,0,0,8,4,5,4,2,1,1,4,5,4,8,"standard","2022-09-12T00:00:00.000Z","[2841,398,3211,2716,2483]","[3062,494,1802,3582,3346]","Viper,Astra,KAY/O,Chamber,Fade","Astra,KAY/O,Chamber,Neon,Fade",1588
79080,35252,"VALORANT Champions 2022 - Playoffs","Ascent",6426,"OpTic Gaming",603,"XSET",1,11,13,3,9,2,1,1,3,9,8,4,0,0,0,4,8,9,3,"standard","2022-09-12T00:00:00.000Z","[2483,398,3211,2716,2841]","[3582,3062,3346,1802,494]","Sova,Astra,KAY/O,Chamber,Fade","Sova,Killjoy,Omen,Jett,KAY/O",1588
79079,35252,"VALORANT Champions 2022 - Playoffs","Haven",6426,"OpTic Gaming",603,"XSET",2,13,9,4,8,2,1,1,9,1,4,8,0,0,0,8,4,1,9,"standard","2022-09-12T00:00:00.000Z","[2841,3211,398,2716,2483]","[494,3582,3062,1802,3346]","Killjoy,Phoenix,Omen,Chamber,Fade","Breach,Raze,Omen,Chamber,Fade",1588
79062,35246,"VALORANT Champions 2022 - Playoffs","Haven",286,"DRX",6344,"LOUD",1,6,13,4,8,0,0,0,4,8,2,5,2,1,1,5,2,8,4,"standard","2022-09-12T00:00:00.000Z","[582,1550,452,1251,814]","[2895,4748,6037,4746,2294]","Breach,Killjoy,Omen,Jett,Fade","Breach,Raze,Omen,Chamber,Fade",1588
79061,35246,"VALORANT Champions 2022 - Playoffs","Breeze",286,"DRX",6344,"LOUD",1,11,13,9,3,0,0,0,9,3,2,10,2,1,1,10,2,3,9,"standard","2022-09-12T00:00:00.000Z","[814,452,1251,582,1550]","[4746,2294,6037,4748,2895]","Sova,Viper,Jett,Skye,Chamber","Cypher,Sova,Viper,Jett,KAY/O",1588
79083,35253,"VALORANT Champions 2022 - Playoffs","Haven",224,"Team Liquid",1625,"FNATIC",2,7,13,5,7,1,0,1,2,6,5,7,1,0,1,7,5,6,2,"standard","2022-09-11T00:00:00.000Z","[17788,1690,750,10211,2056]","[76,14543,2011,2937,718]","Breach,Raze,Omen,Chamber,Fade","Breach,Raze,Omen,Chamber,Fade",1588
79082,35253,"VALORANT Champions 2022 - Playoffs","Bind",224,"Team Liquid",1625,"FNATIC",2,6,13,3,9,0,0,0,3,4,3,9,2,1,1,9,3,4,3,"standard","2022-09-11T00:00:00.000Z","[1690,17788,750,10211,2056]","[14543,718,2011,76,2937]","Raze,Viper,Brimstone,Sage,Skye","Raze,Viper,Brimstone,Skye,Chamber",1588
79065,35247,"VALORANT Champions 2022 - Playoffs","Ascent",17,"FunPlus Phoenix",738,"Leviatán",1,13,11,5,7,1,0,1,5,7,8,4,1,0,1,4,8,7,5,"standard","2022-09-11T00:00:00.000Z","[2225,2335,3043,1256,2359]","[3531,3421,6414,3532,21588]","Cypher,Omen,Jett,KAY/O,Fade","Sova,Astra,KAY/O,Chamber,Fade",1588
79064,35247,"VALORANT Champions 2022 - Playoffs","Icebox",17,"FunPlus Phoenix",738,"Leviatán",1,13,6,8,4,2,1,1,8,4,5,2,0,0,0,2,5,4,8,"standard","2022-09-11T00:00:00.000Z","[1256,2225,2359,3043,2335]","[3531,6414,3421,21588,3532]","Raze,Viper,Sage,Chamber,Fade","Sova,Viper,Sage,KAY/O,Chamber",1588
79020,35226,"VALORANT Champions 2022 - Playoffs","Fracture",603,"XSET",1625,"FNATIC",2,13,11,5,7,0,0,0,8,4,5,7,2,1,1,7,5,4,8,"standard","2022-09-10T00:00:00.000Z","[494,3062,3346,1802,3582]","[718,2011,76,2937,14543]","Breach,Sage,Omen,Chamber,Neon","Breach,Brimstone,KAY/O,Chamber,Neon",1588
79019,35226,"VALORANT Champions 2022 - Playoffs","Pearl",603,"XSET",1625,"FNATIC",2,13,8,9,3,1,0,1,4,5,9,3,1,0,1,3,9,5,4,"standard","2022-09-10T00:00:00.000Z","[3062,494,1802,3582,3346]","[76,2011,2937,14543,718]","Astra,KAY/O,Chamber,Neon,Fade","Skye,Astra,Chamber,Neon,Fade",1588
79018,35225,"VALORANT Champions 2022 - Playoffs","Ascent",6426,"OpTic Gaming",224,"Team Liquid",1,13,8,10,2,2,1,1,10,2,3,6,0,0,0,6,3,2,10,"standard","2022-09-10T00:00:00.000Z","[2483,398,3211,2716,2841]","[1690,750,17788,10211,2056]","Sova,Astra,KAY/O,Chamber,Fade","Phoenix,Omen,KAY/O,Chamber,Fade",1588
79017,35225,"VALORANT Champions 2022 - Playoffs","Bind",6426,"OpTic Gaming",224,"Team Liquid",1,13,8,7,5,1,1,0,7,5,6,3,1,1,0,3,6,5,7,"standard","2022-09-10T00:00:00.000Z","[3211,2841,398,2483,2716]","[1690,17788,750,10211,2056]","Raze,Viper,Brimstone,Skye,Chamber","Raze,Viper,Brimstone,Sage,Skye",1588
79016,35225,"VALORANT Champions 2022 - Playoffs","Breeze",6426,"OpTic Gaming",224,"Team Liquid",1,7,13,3,9,1,0,1,3,9,4,4,1,0,1,4,4,9,3,"standard","2022-09-10T00:00:00.000Z","[398,2483,2841,2716,3211]","[750,17788,1690,2056,10211]","Breach,Sova,Viper,Chamber,Neon","Sova,Viper,Phoenix,KAY/O,Chamber",1588
79011,35223,"VALORANT Champions 2022 - Playoffs","Breeze",286,"DRX",17,"FunPlus Phoenix",1,13,5,9,3,2,1,1,9,3,4,2,0,0,0,2,4,3,9,"standard","2022-09-09T00:00:00.000Z","[814,452,1251,582,1550]","[2359,2225,2335,3043,1256]","Sova,Viper,Jett,Skye,Chamber","Sova,Viper,Omen,Jett,KAY/O",1588
79010,35223,"VALORANT Champions 2022 - Playoffs","Ascent",286,"DRX",17,"FunPlus Phoenix",2,19,17,7,5,2,1,1,8,10,11,7,0,0,0,7,11,10,8,"standard","2022-09-09T00:00:00.000Z","[814,1251,452,1550,582]","[2225,2335,1256,3043,2359]","Sova,Jett,Astra,KAY/O,Fade","Sage,Omen,KAY/O,Chamber,Fade",1588
79014,35224,"VALORANT Champions 2022 - Playoffs","Haven",738,"Leviatán",6344,"LOUD",1,6,13,5,7,1,1,0,5,7,1,6,1,1,0,6,1,7,5,"standard","2022-09-09T00:00:00.000Z","[3531,6414,3421,3532,21588]","[2895,4748,6037,4746,2294]","Breach,Raze,Omen,Chamber,Fade","Breach,Raze,Omen,Chamber,Fade",1588
79013,35224,"VALORANT Champions 2022 - Playoffs","Icebox",738,"Leviatán",6344,"LOUD",2,12,14,8,4,1,0,1,4,9,8,5,1,0,1,5,8,9,4,"standard","2022-09-09T00:00:00.000Z","[3531,6414,3421,21588,3532]","[2294,4746,6037,2895,4748]","Sova,Viper,Sage,KAY/O,Chamber","Sova,Viper,Sage,KAY/O,Chamber",1588
79005,35221,"VALORANT Champions 2022 - Group Stage","Ascent",305,"100 Thieves",1625,"FNATIC",1,7,13,4,8,1,1,0,4,8,3,5,1,1,0,5,3,8,4,"standard","2022-09-08T00:00:00.000Z","[122,1012,763,2354,269]","[14543,2011,2937,76,718]","Sage,Omen,KAY/O,Chamber,Fade","Killjoy,Omen,Jett,KAY/O,Fade",1588
79004,35221,"VALORANT Champions 2022 - Group Stage","Bind",305,"100 Thieves",1625,"FNATIC",2,5,13,2,10,0,0,0,3,3,2,10,2,1,1,10,2,3,3,"standard","2022-09-08T00:00:00.000Z","[2354,122,1012,763,269]","[14543,718,2011,76,2937]","Raze,Viper,Brimstone,Skye,Fade","Raze,Viper,Brimstone,Skye,Chamber",1588
79008,35222,"VALORANT Champions 2022 - Group Stage","Ascent",17,"FunPlus Phoenix",976,"KRÜ Esports",1,13,4,9,3,2,1,1,9,3,4,1,0,0,0,1,4,3,9,"standard","2022-09-08T00:00:00.000Z","[2225,2335,1256,3043,2359]","[2532,3535,1725,4710,4712]","Sage,Omen,KAY/O,Chamber,Fade","Killjoy,Omen,Jett,KAY/O,Fade",1588
79007,35222,"VALORANT Champions 2022 - Group Stage","Icebox",17,"FunPlus Phoenix",976,"KRÜ Esports",2,13,9,7,5,1,0,1,6,4,7,5,1,0,1,5,7,4,6,"standard","2022-09-08T00:00:00.000Z","[2225,2359,1256,3043,2335]","[4712,3535,4710,1725,2532]","Viper,Sage,KAY/O,Chamber,Fade","Sova,Viper,Sage,KAY/O,Chamber",1588
78987,35215,"VALORANT Champions 2022 - Group Stage","Ascent",6344,"LOUD",611,"ZETA DIVISION",1,13,5,7,5,1,0,1,7,5,6,0,1,0,1,0,6,5,7,"standard","2022-09-07T00:00:00.000Z","[2294,4746,6037,4748,2895]","[2699,519,1593,2232,2212]","Sova,Killjoy,Omen,Jett,KAY/O","Sova,Killjoy,Jett,Astra,KAY/O",1588
78986,35215,"VALORANT Champions 2022 - Group Stage","Bind",6344,"LOUD",611,"ZETA DIVISION",1,13,11,7,5,0,0,0,7,5,6,6,2,1,1,6,6,5,7,"standard","2022-09-07T00:00:00.000Z","[4748,4746,6037,2895,2294]","[2699,519,2232,1593,2212]","Raze,Viper,Brimstone,Skye,Fade","Breach,Raze,Brimstone,Jett,Skye",1588
78991,35216,"VALORANT Champions 2022 - Group Stage","Ascent",184,"Paper Rex",224,"Team Liquid",1,8,13,4,8,1,1,0,4,8,4,5,1,1,0,5,4,8,4,"standard","2022-09-07T00:00:00.000Z","[432,8385,8388,8386,8387]","[1690,750,17788,10211,2056]","Raze,Astra,KAY/O,Chamber,Fade","Phoenix,Omen,KAY/O,Chamber,Fade",1588
78990,35216,"VALORANT Champions 2022 - Group Stage","Pearl",184,"Paper Rex",224,"Team Liquid",1,13,4,8,4,1,0,1,8,4,5,0,1,0,1,0,5,4,8,"standard","2022-09-07T00:00:00.000Z","[432,8388,8385,8386,8387]","[17788,1690,750,10211,2056]","Raze,Sage,Astra,Chamber,Fade","Viper,Phoenix,Astra,Chamber,Fade",1588
78989,35216,"VALORANT Champions 2022 - Group Stage","Haven",184,"Paper Rex",224,"Team Liquid",1,13,15,5,7,2,1,1,5,9,8,6,0,0,0,6,8,9,5,"standard","2022-09-07T00:00:00.000Z","[8387,432,8386,8388,8385]","[17788,1690,750,10211,2056]","Cypher,Reyna,Jett,Skye,Astra","Breach,Raze,Omen,Chamber,Fade",1588
78940,35199,"VALORANT Champions 2022 - Group Stage","Breeze",17,"FunPlus Phoenix",603,"XSET",1,5,13,1,11,0,0,0,1,11,4,2,2,1,1,2,4,11,1,"standard","2022-09-05T00:00:00.000Z","[2225,2359,2335,3043,1256]","[494,3346,3062,1802,3582]","Cypher,Sova,Viper,Jett,Skye","Cypher,Sova,Viper,Jett,KAY/O",1588
78939,35199,"VALORANT Champions 2022 - Group Stage","Fracture",17,"FunPlus Phoenix",603,"XSET",1,13,4,8,4,2,1,1,8,4,5,0,0,0,0,0,5,4,8,"standard","2022-09-05T00:00:00.000Z","[1256,2225,2335,3043,2359]","[494,3062,3346,1802,3582]","Raze,Viper,Omen,Chamber,Fade","Breach,Sage,Omen,Chamber,Neon",1588
78938,35199,"VALORANT Champions 2022 - Group Stage","Pearl",17,"FunPlus Phoenix",603,"XSET",2,7,13,6,6,0,0,0,1,7,6,6,2,1,1,6,6,7,1,"standard","2022-09-05T00:00:00.000Z","[1256,3043,2225,2335,2359]","[3062,494,1802,3582,3346]","Raze,Cypher,Viper,Omen,Fade","Astra,KAY/O,Chamber,Neon,Fade",1588
78842,35157,"VALORANT Champions 2022 - Group Stage","Haven",1264,"FURIA",1625,"FNATIC",2,11,13,6,6,1,0,1,5,7,6,6,1,0,1,6,6,7,5,"standard","2022-09-05T00:00:00.000Z","[6039,2749,2423,6038,2752]","[76,14543,2011,2937,718]","Sage,Omen,Skye,Chamber,Fade","Breach,Raze,Omen,Chamber,Fade",1588
78841,35157,"VALORANT Champions 2022 - Group Stage","Breeze",1264,"FURIA",1625,"FNATIC",2,7,13,2,10,1,1,0,5,3,2,10,1,1,0,10,2,3,5,"standard","2022-09-05T00:00:00.000Z","[2752,2749,6039,6038,2423]","[76,718,2011,2937,14543]","Sova,Viper,Jett,KAY/O,Chamber","Breach,Sova,Viper,Chamber,Neon",1588
78840,35157,"VALORANT Champions 2022 - Group Stage","Icebox",1264,"FURIA",1625,"FNATIC",2,13,9,7,5,1,0,1,6,4,7,5,1,0,1,5,7,4,6,"standard","2022-09-05T00:00:00.000Z","[2752,2749,2423,6039,6038]","[718,14543,2011,76,2937]","Sova,Viper,Sage,KAY/O,Chamber","Sova,Killjoy,Viper,Sage,Chamber",1588
78943,35200,"VALORANT Champions 2022 - Group Stage","Ascent",976,"KRÜ Esports",5903,"XERXIA Esports",2,13,6,7,5,2,1,1,6,1,7,5,0,0,0,5,7,1,6,"standard","2022-09-05T00:00:00.000Z","[2532,3535,1725,4710,4712]","[3642,671,766,21245,6890]","Killjoy,Omen,Jett,KAY/O,Fade","Breach,Killjoy,Omen,Jett,Fade",1588
78942,35200,"VALORANT Champions 2022 - Group Stage","Haven",976,"KRÜ Esports",5903,"XERXIA Esports",2,7,13,4,8,0,0,0,3,5,4,8,2,1,1,8,4,5,3,"standard","2022-09-05T00:00:00.000Z","[4710,3535,4712,2532,1725]","[3642,766,6890,21245,671]","Sage,Omen,KAY/O,Chamber,Fade","Breach,Omen,Skye,Chamber,Neon",1588
78941,35200,"VALORANT Champions 2022 - Group Stage","Icebox",976,"KRÜ Esports",5903,"XERXIA Esports",1,13,4,9,3,2,1,1,9,3,4,1,0,0,0,1,4,3,9,"standard","2022-09-05T00:00:00.000Z","[4712,3535,4710,1725,2532]","[6890,671,766,3642,21245]","Sova,Viper,Sage,KAY/O,Chamber","Sova,Killjoy,Viper,Sage,Jett",1588
78749,35123,"VALORANT Champions 2022 - Group Stage","Breeze",808,"EDward Gaming",224,"Team Liquid",1,12,14,5,7,2,1,1,5,8,7,6,0,0,0,6,7,8,5,"standard","2022-09-04T00:00:00.000Z","[4075,14484,4072,4070,4077]","[750,17788,1690,2056,10211]","Sova,Viper,Jett,Skye,Chamber","Sova,Viper,Phoenix,KAY/O,Chamber",1588
78748,35123,"VALORANT Champions 2022 - Group Stage","Bind",808,"EDward Gaming",224,"Team Liquid",1,5,13,4,8,1,1,0,4,8,1,5,1,1,0,5,1,8,4,"standard","2022-09-04T00:00:00.000Z","[4070,4077,4072,14484,4075]","[1690,17788,750,10211,2056]","Breach,Raze,Jett,Astra,Fade","Raze,Viper,Brimstone,Sage,Skye",1588
78780,35133,"VALORANT Champions 2022 - Group Stage","Fracture",15,"BOOM Esports",611,"ZETA DIVISION",1,2,13,2,10,1,1,0,2,10,0,3,1,1,0,3,0,10,2,"standard","2022-09-04T00:00:00.000Z","[3365,386,1919,217,3363]","[2699,519,2232,2212,1593]","Breach,Raze,Brimstone,Chamber,Neon","Breach,Raze,Brimstone,Chamber,Neon",1588
78779,35133,"VALORANT Champions 2022 - Group Stage","Pearl",15,"BOOM Esports",611,"ZETA DIVISION",2,11,13,4,8,2,1,1,7,5,4,8,0,0,0,8,4,5,7,"standard","2022-09-04T00:00:00.000Z","[217,3365,386,3363,1919]","[519,2232,1593,2699,2212]","Viper,Omen,Chamber,Neon,Fade","Raze,Viper,Omen,Skye,Chamber",1588
78778,35133,"VALORANT Champions 2022 - Group Stage","Haven",15,"BOOM Esports",611,"ZETA DIVISION",1,13,11,4,8,2,1,1,4,8,9,3,0,0,0,3,9,8,4,"standard","2022-09-04T00:00:00.000Z","[3365,386,217,3363,1919]","[2232,519,2212,1593,2699]","Breach,Sova,Killjoy,Jett,Astra","Omen,KAY/O,Chamber,Neon,Fade",1588
78838,35156,"VALORANT Champions 2022 - Group Stage","Fracture",286,"DRX",305,"100 Thieves",1,13,9,9,3,2,1,1,9,3,4,6,0,0,0,6,4,3,9,"standard","2022-09-03T00:00:00.000Z","[582,452,1251,1550,814]","[269,1012,122,2354,763]","Breach,Brimstone,Chamber,Neon,Fade","Breach,Brimstone,KAY/O,Chamber,Neon",1588
78837,35156,"VALORANT Champions 2022 - Group Stage","Breeze",286,"DRX",305,"100 Thieves",1,18,16,7,5,1,1,0,10,7,8,9,1,1,0,9,8,7,10,"standard","2022-09-03T00:00:00.000Z","[814,452,1251,582,1550]","[122,269,1012,2354,763]","Sova,Viper,Jett,Skye,Chamber","Cypher,Sova,Viper,Jett,KAY/O",1588
77113,34424,"VALORANT Champions 2022 - Group Stage","Bind",17,"FunPlus Phoenix",976,"KRÜ Esports",1,13,10,5,7,2,1,1,5,7,8,3,0,0,0,3,8,7,5,"standard","2022-09-03T00:00:00.000Z","[1256,2225,2335,3043,2359]","[1725,4712,3535,2532,4710]","Raze,Viper,Brimstone,KAY/O,Fade","Raze,Viper,Brimstone,Sage,Skye",1588
77112,34424,"VALORANT Champions 2022 - Group Stage","Icebox",17,"FunPlus Phoenix",976,"KRÜ Esports",2,14,12,3,9,1,1,0,10,3,4,9,1,1,0,9,4,3,10,"standard","2022-09-03T00:00:00.000Z","[1256,2225,2359,3043,2335]","[4712,3535,4710,1725,2532]","Raze,Viper,Sage,Chamber,Fade","Sova,Viper,Sage,KAY/O,Chamber",1588
77116,34425,"VALORANT Champions 2022 - Group Stage","Icebox",603,"XSET",5903,"XERXIA Esports",2,13,10,7,5,1,1,0,6,5,7,5,1,1,0,5,7,5,6,"standard","2022-09-03T00:00:00.000Z","[3582,3062,494,1802,3346]","[671,766,6890,3642,21245]","Raze,Viper,KAY/O,Chamber,Fade","Sova,Viper,Yoru,Astra,Chamber",1588
77115,34425,"VALORANT Champions 2022 - Group Stage","Fracture",603,"XSET",5903,"XERXIA Esports",2,13,11,7,5,0,0,0,6,6,7,5,2,1,1,5,7,6,6,"standard","2022-09-03T00:00:00.000Z","[494,3062,3346,1802,3582]","[671,766,6890,3642,21245]","Breach,Sage,Omen,Chamber,Neon","Breach,Viper,Phoenix,Omen,Chamber",1588
78783,35134,"VALORANT Champions 2022 - Group Stage","Pearl",6344,"LOUD",6426,"OpTic Gaming",1,3,13,3,9,1,1,0,3,9,0,4,1,1,0,4,0,9,3,"standard","2022-09-02T00:00:00.000Z","[4746,6037,2895,4748,2294]","[2841,398,3211,2716,2483]","Viper,Astra,KAY/O,Chamber,Fade","Viper,Astra,KAY/O,Chamber,Fade",1588
78782,35134,"VALORANT Champions 2022 - Group Stage","Fracture",6344,"LOUD",6426,"OpTic Gaming",2,10,13,6,6,1,1,0,4,7,6,6,1,1,0,6,6,7,4,"standard","2022-09-02T00:00:00.000Z","[4748,2895,6037,4746,2294]","[2841,398,2483,2716,3211]","Raze,Viper,Omen,Chamber,Fade","Breach,Brimstone,KAY/O,Chamber,Neon",1588
78781,35134,"VALORANT Champions 2022 - Group Stage","Breeze",6344,"LOUD",6426,"OpTic Gaming",2,13,7,11,1,1,0,1,2,6,11,1,1,0,1,1,11,6,2,"standard","2022-09-02T00:00:00.000Z","[4746,2294,6037,4748,2895]","[2483,2841,3211,398,2716]","Cypher,Sova,Viper,Jett,KAY/O","Sova,Viper,Jett,KAY/O,Chamber",1588
77123,34427,"VALORANT Champions 2022 - Group Stage","Haven",1625,"FNATIC",305,"100 Thieves",1,7,13,6,6,0,0,0,6,6,1,7,2,1,1,7,1,6,6,"standard","2022-09-02T00:00:00.000Z","[76,14543,2011,2937,718]","[763,122,1012,2354,269]","Breach,Raze,Astra,Chamber,Fade","Raze,Sage,Omen,Chamber,Fade",1588
77122,34427,"VALORANT Champions 2022 - Group Stage","Bind",1625,"FNATIC",305,"100 Thieves",2,13,7,8,4,2,1,1,5,3,8,4,0,0,0,4,8,3,5,"standard","2022-09-02T00:00:00.000Z","[14543,718,2011,76,2937]","[2354,122,1012,763,269]","Raze,Viper,Brimstone,Skye,Chamber","Raze,Viper,Brimstone,Skye,Fade",1588
77121,34427,"VALORANT Champions 2022 - Group Stage","Pearl",1625,"FNATIC",305,"100 Thieves",1,10,13,6,6,0,0,0,6,6,4,7,2,1,1,7,4,6,6,"standard","2022-09-02T00:00:00.000Z","[76,2011,2937,14543,718]","[2354,122,763,1012,269]","Skye,Astra,Chamber,Neon,Fade","Raze,Viper,Sage,Astra,Fade",1588
77119,34426,"VALORANT Champions 2022 - Group Stage","Haven",286,"DRX",1264,"FURIA",2,13,4,8,4,2,1,1,5,0,8,4,0,0,0,4,8,0,5,"standard","2022-09-02T00:00:00.000Z","[582,1550,452,1251,814]","[6039,2423,2749,6038,2752]","Breach,Killjoy,Omen,Jett,Fade","Breach,Raze,Omen,Chamber,Fade",1588
77118,34426,"VALORANT Champions 2022 - Group Stage","Ascent",286,"DRX",1264,"FURIA",1,16,14,3,9,0,0,0,5,10,11,4,2,1,1,4,11,10,5,"standard","2022-09-02T00:00:00.000Z","[814,1251,452,1550,582]","[2752,2423,2749,6038,6039]","Sova,Jett,Astra,KAY/O,Fade","Sova,Killjoy,Omen,Jett,KAY/O",1588
78746,35122,"VALORANT Champions 2022 - Group Stage","Bind",184,"Paper Rex",738,"Leviatán",1,11,13,6,6,0,0,0,6,6,5,7,2,1,1,7,5,6,6,"standard","2022-09-01T00:00:00.000Z","[8387,432,8385,8386,8388]","[6414,3531,3421,3532,21588]","Breach,Raze,Brimstone,Yoru,Fade","Raze,Viper,Brimstone,Skye,Fade",1588
78745,35122,"VALORANT Champions 2022 - Group Stage","Haven",184,"Paper Rex",738,"Leviatán",1,8,13,6,6,0,0,0,6,6,2,7,2,1,1,7,2,6,6,"standard","2022-09-01T00:00:00.000Z","[432,8387,8385,8386,8388]","[3531,6414,3421,3532,21588]","Raze,Sage,Astra,Chamber,Fade","Breach,Raze,Omen,Chamber,Fade",1588
77108,34422,"VALORANT Champions 2022 - Group Stage","Fracture",6426,"OpTic Gaming",15,"BOOM Esports",2,13,3,9,3,1,1,0,4,0,9,3,1,1,0,3,9,0,4,"standard","2022-09-01T00:00:00.000Z","[2841,398,2483,2716,3211]","[3365,1919,386,217,3363]","Breach,Brimstone,KAY/O,Chamber,Neon","Breach,Brimstone,KAY/O,Chamber,Neon",1588
77107,34422,"VALORANT Champions 2022 - Group Stage","Bind",6426,"OpTic Gaming",15,"BOOM Esports",2,13,5,10,2,1,0,1,3,3,10,2,1,0,1,2,10,3,3,"standard","2022-09-01T00:00:00.000Z","[3211,2841,398,2483,2716]","[386,217,3363,3365,1919]","Raze,Viper,Brimstone,Skye,Chamber","Raze,Viper,Skye,Astra,Fade",1588
77106,34422,"VALORANT Champions 2022 - Group Stage","Breeze",6426,"OpTic Gaming",15,"BOOM Esports",1,16,18,4,8,2,1,1,6,11,10,7,0,0,0,7,10,11,6,"standard","2022-09-01T00:00:00.000Z","[2483,2841,3211,398,2716]","[1919,3365,3363,217,386]","Sova,Viper,Jett,KAY/O,Chamber","Sova,Viper,Jett,KAY/O,Chamber",1588
77110,34423,"VALORANT Champions 2022 - Group Stage","Fracture",611,"ZETA DIVISION",6344,"LOUD",2,9,13,7,5,1,0,1,2,8,7,5,1,0,1,5,7,8,2,"standard","2022-09-01T00:00:00.000Z","[2699,519,2232,2212,1593]","[4748,2895,6037,4746,2294]","Breach,Raze,Brimstone,Chamber,Neon","Raze,Viper,Omen,Chamber,Fade",1588
77109,34423,"VALORANT Champions 2022 - Group Stage","Ascent",611,"ZETA DIVISION",6344,"LOUD",2,8,13,7,5,1,0,1,1,8,7,5,1,0,1,5,7,8,1,"standard","2022-09-01T00:00:00.000Z","[519,1593,2232,2212,2699]","[2294,4746,6037,4748,2895]","Killjoy,Jett,Astra,KAY/O,Fade","Sova,Killjoy,Omen,Jett,KAY/O",1588
77104,34421,"VALORANT Champions 2022 - Group Stage","Ascent",738,"Leviatán",224,"Team Liquid",1,13,10,6,6,2,1,1,6,6,7,4,0,0,0,4,7,6,6,"standard","2022-08-31T00:00:00.000Z","[3531,3421,6414,3532,21588]","[1690,750,17788,10211,2056]","Sova,Astra,KAY/O,Chamber,Fade","Phoenix,Omen,KAY/O,Chamber,Fade",1588
77103,34421,"VALORANT Champions 2022 - Group Stage","Haven",738,"Leviatán",224,"Team Liquid",2,13,10,8,4,2,1,1,5,6,8,4,0,0,0,4,8,6,5,"standard","2022-08-31T00:00:00.000Z","[3531,6414,3421,3532,21588]","[17788,1690,750,10211,2056]","Breach,Raze,Omen,Chamber,Fade","Breach,Raze,Omen,Chamber,Fade",1588
77102,34420,"VALORANT Champions 2022 - Group Stage","Haven",184,"Paper Rex",808,"EDward Gaming",2,13,8,7,5,2,1,1,6,3,7,5,0,0,0,5,7,3,6,"standard","2022-08-31T00:00:00.000Z","[8387,432,8386,8388,8385]","[4070,14484,4333,4077,4075]","Cypher,Reyna,Jett,Skye,Astra","Breach,Omen,Jett,Chamber,Fade",1588
77101,34420,"VALORANT Champions 2022 - Group Stage","Icebox",184,"Paper Rex",808,"EDward Gaming",2,5,13,2,10,1,1,0,3,3,2,10,1,1,0,10,2,3,3,"standard","2022-08-31T00:00:00.000Z","[8385,432,8386,8388,8387]","[4075,4070,14484,4333,4077]","Viper,Sage,Jett,Chamber,Fade","Sova,Viper,Sage,Jett,Chamber",1588
77100,34420,"VALORANT Champions 2022 - Group Stage","Pearl",184,"Paper Rex",808,"EDward Gaming",1,13,11,6,6,1,0,1,6,6,7,5,1,0,1,5,7,6,6,"standard","2022-08-31T00:00:00.000Z","[432,8388,8385,8386,8387]","[14484,4070,4333,4077,4075]","Raze,Sage,Astra,Chamber,Fade","Viper,Astra,KAY/O,Chamber,Fade",1588
76755,34293,"VCT 2022 - North America - Last Chance Qualifier","Haven",5201,"The Guard",305,"100 Thieves",1,9,13,5,7,1,1,0,5,7,4,6,1,1,0,6,4,7,5,"standard","2022-08-14T00:00:00.000Z","[4141,2551,1804,1091,11412]","[763,122,1012,2354,269]","Breach,Raze,Omen,Chamber,Fade","Raze,Sage,Omen,Chamber,Fade",1588
76754,34293,"VCT 2022 - North America - Last Chance Qualifier","Fracture",5201,"The Guard",305,"100 Thieves",1,6,13,3,9,1,0,1,3,9,3,4,1,0,1,4,3,9,3,"standard","2022-08-14T00:00:00.000Z","[4141,1804,2551,1091,11412]","[269,1012,122,2354,763]","Breach,Brimstone,Jett,Chamber,Fade","Breach,Brimstone,KAY/O,Chamber,Neon",1588
76753,34293,"VCT 2022 - North America - Last Chance Qualifier","Icebox",5201,"The Guard",305,"100 Thieves",1,7,13,4,8,0,0,0,4,8,3,5,2,1,1,5,3,8,4,"standard","2022-08-14T00:00:00.000Z","[4141,1091,1804,2551,11412]","[269,1012,122,763,2354]","Viper,Brimstone,KAY/O,Chamber,Fade","Sova,Viper,Sage,KAY/O,Chamber",1588
76816,34310,"VCT 2022 - South America - Last Chance Qualifier","Breeze",1264,"FURIA",5747,"TBK Esports",1,13,10,5,7,1,1,0,5,7,8,3,1,1,0,3,8,7,5,"standard","2022-08-14T00:00:00.000Z","[2752,2749,6039,6038,2423]","[2366,9831,1506,5580,2457]","Sova,Viper,Jett,KAY/O,Chamber","Sova,Viper,Jett,KAY/O,Chamber",1588
76815,34310,"VCT 2022 - South America - Last Chance Qualifier","Fracture",1264,"FURIA",5747,"TBK Esports",2,13,6,7,5,1,1,0,6,1,7,5,1,1,0,5,7,1,6,"standard","2022-08-14T00:00:00.000Z","[2752,2749,6039,2423,6038]","[5580,2366,2457,9831,1506]","Breach,Brimstone,Sage,Chamber,Neon","Breach,Raze,Viper,Astra,Chamber",1588
76822,34311,"VCT 2022 - EMEA - Last Chance Qualifier","Breeze",6656,"M3 Champions",224,"Team Liquid",1,8,13,5,7,2,1,1,5,7,3,6,0,0,0,6,3,7,5,"standard","2022-08-14T00:00:00.000Z","[1964,1081,509,2528,274]","[750,17788,1690,2056,10211]","Sova,Viper,Jett,Skye,Chamber","Sova,Viper,Jett,Skye,Chamber",1588
76814,34310,"VCT 2022 - South America - Last Chance Qualifier","Ascent",1264,"FURIA",5747,"TBK Esports",1,13,11,5,7,1,0,1,5,7,8,4,1,0,1,4,8,7,5,"standard","2022-08-14T00:00:00.000Z","[2752,2423,2749,6038,6039]","[5580,2457,2366,9831,1506]","Sova,Killjoy,Omen,Jett,KAY/O","Sova,Killjoy,Sage,Omen,Jett",1588
76821,34311,"VCT 2022 - EMEA - Last Chance Qualifier","Ascent",6656,"M3 Champions",224,"Team Liquid",1,6,13,4,8,0,0,0,4,8,2,5,2,1,1,5,2,8,4,"standard","2022-08-14T00:00:00.000Z","[1964,1081,2528,274,2154]","[1690,750,17788,10211,2056]","Sova,Astra,KAY/O,Chamber,Fade","Phoenix,Omen,KAY/O,Chamber,Fade",1588
76820,34311,"VCT 2022 - EMEA - Last Chance Qualifier","Icebox",6656,"M3 Champions",224,"Team Liquid",1,11,13,5,7,2,1,1,5,7,6,6,0,0,0,6,6,7,5,"standard","2022-08-14T00:00:00.000Z","[1964,1081,2154,2528,274]","[1690,17788,750,10211,2056]","Sova,Viper,Sage,KAY/O,Chamber","Raze,Viper,Sage,Chamber,Fade",1588
76819,34311,"VCT 2022 - EMEA - Last Chance Qualifier","Bind",6656,"M3 Champions",224,"Team Liquid",1,13,8,7,5,0,0,0,7,5,6,3,2,1,1,3,6,5,7,"standard","2022-08-14T00:00:00.000Z","[274,1081,1964,2154,2528]","[1690,17788,750,2056,10211]","Raze,Viper,Omen,Skye,Fade","Raze,Viper,Brimstone,Skye,Chamber",1588
76389,34147,"VCT 2022 - South America - Last Chance Qualifier","Icebox",1264,"FURIA",976,"KRÜ Esports",2,6,13,4,8,0,0,0,2,5,4,8,2,1,1,8,4,5,2,"standard","2022-08-13T00:00:00.000Z","[2752,2749,6039,2423,6038]","[4712,3535,4710,1725,2532]","Sova,Killjoy,Viper,Sage,Chamber","Sova,Viper,Sage,KAY/O,Chamber",1588
76760,34294,"VCT 2022 - North America - Last Chance Qualifier","Ascent",617,"FaZe Clan",305,"100 Thieves",1,3,13,3,9,0,0,0,3,9,0,4,2,1,1,4,0,9,3,"standard","2022-08-13T00:00:00.000Z","[1689,369,1994,1990,789]","[122,1012,763,2354,269]","Sova,Phoenix,Omen,KAY/O,Chamber","Sage,Omen,KAY/O,Chamber,Fade",1588
76759,34294,"VCT 2022 - North America - Last Chance Qualifier","Breeze",617,"FaZe Clan",305,"100 Thieves",1,6,13,5,7,1,1,0,5,7,1,6,1,1,0,6,1,7,5,"standard","2022-08-13T00:00:00.000Z","[1689,1994,369,1990,789]","[122,269,1012,2354,763]","Sova,Viper,Jett,KAY/O,Chamber","Cypher,Sova,Viper,Jett,KAY/O",1588
76388,34147,"VCT 2022 - South America - Last Chance Qualifier","Ascent",1264,"FURIA",976,"KRÜ Esports",1,14,16,5,7,1,0,1,7,8,7,8,1,0,1,8,7,8,7,"standard","2022-08-13T00:00:00.000Z","[2752,2423,2749,6038,6039]","[2532,3535,1725,4710,4712]","Sova,Killjoy,Omen,Jett,KAY/O","Killjoy,Omen,Jett,KAY/O,Fade",1588
76813,34309,"VCT 2022 - EMEA - Last Chance Qualifier","Haven",224,"Team Liquid",194,"G2 Esports (Inactive)",1,13,8,5,7,2,1,1,5,7,8,1,0,0,0,1,8,7,5,"standard","2022-08-13T00:00:00.000Z","[17788,1690,750,10211,2056]","[2594,1826,2377,2769,2940]","Breach,Raze,Omen,Chamber,Fade","Breach,Sova,Killjoy,Astra,Neon",1588
76758,34294,"VCT 2022 - North America - Last Chance Qualifier","Icebox",617,"FaZe Clan",305,"100 Thieves",2,10,13,6,6,2,1,1,4,7,6,6,0,0,0,6,6,7,4,"standard","2022-08-13T00:00:00.000Z","[369,1689,1994,1990,789]","[269,1012,122,763,2354]","Raze,Sova,Viper,KAY/O,Chamber","Sova,Viper,Sage,KAY/O,Chamber",1588
76387,34147,"VCT 2022 - South America - Last Chance Qualifier","Breeze",1264,"FURIA",976,"KRÜ Esports",1,9,13,5,7,1,0,1,5,7,4,6,1,0,1,6,4,7,5,"standard","2022-08-13T00:00:00.000Z","[2752,2749,6039,6038,2423]","[4712,3535,1725,4710,2532]","Sova,Viper,Jett,KAY/O,Chamber","Sova,Viper,Jett,KAY/O,Chamber",1588
76812,34309,"VCT 2022 - EMEA - Last Chance Qualifier","Icebox",224,"Team Liquid",194,"G2 Esports (Inactive)",1,13,10,8,4,1,1,0,8,4,5,6,1,1,0,6,5,4,8,"standard","2022-08-13T00:00:00.000Z","[1690,17788,750,10211,2056]","[1826,2377,2769,2594,2940]","Raze,Viper,Sage,Chamber,Fade","Sova,Killjoy,Viper,Sage,Chamber",1588
76561,34221,"VCT 2022 - South America - Last Chance Qualifier","Fracture",5747,"TBK Esports",600,"Keyd Stars",1,13,8,7,5,0,0,0,7,5,6,3,2,1,1,3,6,5,7,"standard","2022-08-13T00:00:00.000Z","[5580,2366,2457,9831,1506]","[957,81,4771,277,5288]","Breach,Raze,Viper,Astra,Chamber","Breach,Raze,Brimstone,Sage,Chamber",1588
76811,34309,"VCT 2022 - EMEA - Last Chance Qualifier","Bind",224,"Team Liquid",194,"G2 Esports (Inactive)",2,10,13,7,5,1,1,0,3,8,7,5,1,1,0,5,7,8,3,"standard","2022-08-13T00:00:00.000Z","[1690,17788,750,2056,10211]","[1826,2377,2594,2769,2940]","Raze,Viper,Brimstone,Skye,Chamber","Raze,Viper,Skye,Astra,Chamber",1588
76560,34221,"VCT 2022 - South America - Last Chance Qualifier","Bind",5747,"TBK Esports",600,"Keyd Stars",1,10,13,5,7,2,1,1,5,7,5,6,0,0,0,6,5,7,5,"standard","2022-08-13T00:00:00.000Z","[1506,2457,2366,9831,5580]","[81,277,4771,957,5288]","Raze,Viper,Skye,Astra,Fade","Raze,Viper,Omen,Skye,Chamber",1588
76665,34256,"VCT 2022 - EMEA - Last Chance Qualifier","Haven",194,"G2 Esports (Inactive)",7050,"OG LDN UTD",2,13,11,5,7,2,1,1,8,4,5,7,0,0,0,7,5,4,8,"standard","2022-08-13T00:00:00.000Z","[2594,1826,2377,2769,2940]","[2199,2561,2305,1894,426]","Breach,Sova,Killjoy,Astra,Neon","Breach,Raze,Astra,Chamber,Fade",1588
76559,34221,"VCT 2022 - South America - Last Chance Qualifier","Breeze",5747,"TBK Esports",600,"Keyd Stars",2,13,11,4,8,1,1,0,9,3,4,8,1,1,0,8,4,3,9,"standard","2022-08-13T00:00:00.000Z","[2366,9831,1506,5580,2457]","[957,4771,5288,277,81]","Sova,Viper,Jett,KAY/O,Chamber","Sova,Viper,Jett,KAY/O,Chamber",1588
76664,34256,"VCT 2022 - EMEA - Last Chance Qualifier","Bind",194,"G2 Esports (Inactive)",7050,"OG LDN UTD",1,13,8,7,5,0,0,0,7,5,6,3,2,1,1,3,6,5,7,"standard","2022-08-13T00:00:00.000Z","[1826,2377,2594,2769,2940]","[1894,2199,2305,2561,426]","Raze,Viper,Skye,Astra,Chamber","Raze,Viper,Astra,KAY/O,Fade",1588
76651,34251,"VCT 2022 - EMEA - Last Chance Qualifier","Icebox",6656,"M3 Champions",224,"Team Liquid",1,18,16,8,4,1,0,1,11,6,7,10,1,0,1,10,7,6,11,"standard","2022-08-13T00:00:00.000Z","[1964,1081,2154,2528,274]","[1690,17788,750,10211,2056]","Sova,Viper,Sage,KAY/O,Chamber","Raze,Viper,Sage,Chamber,Fade",1588
76650,34251,"VCT 2022 - EMEA - Last Chance Qualifier","Bind",6656,"M3 Champions",224,"Team Liquid",1,13,8,7,5,1,0,1,7,5,6,3,1,0,1,3,6,5,7,"standard","2022-08-13T00:00:00.000Z","[274,1081,1964,2154,2528]","[1690,17788,750,2056,10211]","Raze,Viper,Omen,Skye,Fade","Raze,Viper,Brimstone,Skye,Chamber",1588
76649,34251,"VCT 2022 - EMEA - Last Chance Qualifier","Breeze",6656,"M3 Champions",224,"Team Liquid",1,8,13,4,8,2,1,1,4,8,4,5,0,0,0,5,4,8,4,"standard","2022-08-13T00:00:00.000Z","[1081,1964,2154,274,2528]","[750,17788,1690,2056,10211]","Cypher,Sova,Viper,Jett,KAY/O","Sova,Viper,Jett,Skye,Chamber",1588
76680,34269,"VCT 2022 - North America - Last Chance Qualifier","Fracture",305,"100 Thieves",141,"Cloud9",2,13,10,7,5,1,0,1,6,5,7,5,1,0,1,5,7,5,6,"standard","2022-08-12T00:00:00.000Z","[269,763,1012,122,2354]","[3599,3773,4639,2213,13591]","Breach,Raze,Brimstone,KAY/O,Chamber","Raze,Viper,Omen,Chamber,Fade",1588
76679,34269,"VCT 2022 - North America - Last Chance Qualifier","Ascent",305,"100 Thieves",141,"Cloud9",1,13,7,7,5,1,0,1,7,5,6,2,1,0,1,2,6,5,7,"standard","2022-08-12T00:00:00.000Z","[122,1012,763,2354,269]","[2213,4639,3599,13591,3773]","Sage,Omen,KAY/O,Chamber,Fade","Killjoy,Omen,Jett,KAY/O,Fade",1588
76343,34132,"VCT 2022 - North America - Last Chance Qualifier","Icebox",5201,"The Guard",617,"FaZe Clan",2,13,7,8,4,1,1,0,5,3,8,4,1,1,0,4,8,3,5,"standard","2022-08-12T00:00:00.000Z","[4141,1091,1804,2551,11412]","[369,1689,1994,1990,789]","Viper,Brimstone,KAY/O,Chamber,Fade","Raze,Sova,Viper,KAY/O,Chamber",1588
76342,34132,"VCT 2022 - North America - Last Chance Qualifier","Haven",5201,"The Guard",617,"FaZe Clan",2,13,5,8,4,1,1,0,5,1,8,4,1,1,0,4,8,1,5,"standard","2022-08-12T00:00:00.000Z","[4141,2551,1804,1091,11412]","[369,1689,1994,789,1990]","Breach,Raze,Omen,Chamber,Fade","Raze,Sage,Omen,Chamber,Fade",1588
76215,34080,"VCT 2022 - North America - Last Chance Qualifier","Icebox",141,"Cloud9",116,"NRG Esports",2,13,8,6,6,1,1,0,7,2,6,6,1,1,0,6,6,2,7,"standard","2022-08-12T00:00:00.000Z","[4639,2213,3773,3599,13591]","[1597,1232,10253,165,1763]","Viper,Sage,KAY/O,Chamber,Fade","Sova,Viper,Sage,KAY/O,Chamber",1588
76214,34080,"VCT 2022 - North America - Last Chance Qualifier","Breeze",141,"Cloud9",116,"NRG Esports",1,13,7,9,3,2,1,1,9,3,4,4,0,0,0,4,4,3,9,"standard","2022-08-11T00:00:00.000Z","[2213,3773,4639,13591,3599]","[10253,1597,1232,165,1763]","Cypher,Sova,Viper,KAY/O,Neon","Breach,Sova,Viper,KAY/O,Chamber",1588
76213,34079,"VCT 2022 - North America - Last Chance Qualifier","Haven",305,"100 Thieves",388,"Sentinels",1,13,11,8,4,2,1,1,8,4,5,7,0,0,0,7,5,4,8,"standard","2022-08-11T00:00:00.000Z","[763,122,1012,2354,269]","[893,16735,440,3033,724]","Raze,Sage,Omen,Chamber,Fade","Breach,Omen,KAY/O,Chamber,Fade",1588
76212,34079,"VCT 2022 - North America - Last Chance Qualifier","Breeze",305,"100 Thieves",388,"Sentinels",1,13,7,7,5,2,1,1,7,5,6,2,0,0,0,2,6,5,7,"standard","2022-08-11T00:00:00.000Z","[122,269,1012,2354,763]","[893,16735,440,3033,724]","Cypher,Sova,Viper,Jett,KAY/O","Sova,Viper,KAY/O,Chamber,Fade",1588
76211,34079,"VCT 2022 - North America - Last Chance Qualifier","Fracture",305,"100 Thieves",388,"Sentinels",2,15,17,8,4,1,0,1,5,11,10,6,1,0,1,6,10,11,5,"standard","2022-08-11T00:00:00.000Z","[269,1012,122,2354,763]","[893,16735,724,3033,440]","Breach,Brimstone,KAY/O,Chamber,Neon","Breach,Brimstone,KAY/O,Chamber,Neon",1588
76656,34253,"VCT 2022 - EMEA - Last Chance Qualifier","Haven",7050,"OG LDN UTD",386,"Guild Esports",1,13,10,5,7,0,0,0,5,7,8,3,2,1,1,3,8,7,5,"standard","2022-08-11T00:00:00.000Z","[2199,2561,2305,1894,426]","[449,406,2321,1834,966]","Breach,Raze,Astra,Chamber,Fade","Breach,Raze,Omen,Chamber,Fade",1588
76655,34253,"VCT 2022 - EMEA - Last Chance Qualifier","Breeze",7050,"OG LDN UTD",386,"Guild Esports",1,19,17,8,4,1,0,1,12,6,7,11,1,0,1,11,7,6,12,"standard","2022-08-11T00:00:00.000Z","[426,2199,2305,2561,1894]","[966,449,2321,1834,406]","Sova,Viper,Omen,KAY/O,Chamber","Cypher,Sova,Viper,Jett,KAY/O",1588
76653,34252,"VCT 2022 - EMEA - Last Chance Qualifier","Haven",4220,"Natus Vincere",194,"G2 Esports (Inactive)",1,3,13,1,11,0,0,0,1,11,2,2,2,1,1,2,2,11,1,"standard","2022-08-11T00:00:00.000Z","[2279,2983,491,999,3003]","[2594,1826,2377,2769,2940]","Breach,Raze,Omen,Chamber,Fade","Breach,Sova,Killjoy,Astra,Neon",1588
76652,34252,"VCT 2022 - EMEA - Last Chance Qualifier","Bind",4220,"Natus Vincere",194,"G2 Esports (Inactive)",2,10,13,5,7,0,0,0,5,6,5,7,2,1,1,7,5,6,5,"standard","2022-08-11T00:00:00.000Z","[2983,491,2279,999,3003]","[1826,2377,2594,2769,2940]","Raze,Omen,Skye,Chamber,Fade","Raze,Viper,Skye,Astra,Chamber",1588
76394,34148,"VCT 2022 - South America - Last Chance Qualifier","Icebox",600,"Keyd Stars",5750,"Ninjas in Pyjamas",2,13,2,11,1,2,1,1,2,1,11,1,0,0,0,1,11,1,2,"standard","2022-08-10T00:00:00.000Z","[81,957,4771,277,5288]","[2901,16804,762,3203,2195]","Raze,Sova,Viper,Sage,Chamber","Viper,Sage,KAY/O,Chamber,Fade",1588
76393,34148,"VCT 2022 - South America - Last Chance Qualifier","Ascent",600,"Keyd Stars",5750,"Ninjas in Pyjamas",2,16,14,6,6,1,0,1,8,7,8,7,1,0,1,7,8,7,8,"standard","2022-08-10T00:00:00.000Z","[81,4771,277,5288,957]","[16804,762,2901,3203,2195]","Raze,Omen,KAY/O,Chamber,Fade","Sova,Killjoy,Omen,Jett,Fade",1588
76364,34139,"VCT 2022 - EMEA - Last Chance Qualifier","Fracture",224,"Team Liquid",4220,"Natus Vincere",1,13,11,7,5,1,1,0,7,5,6,6,1,1,0,6,6,5,7,"standard","2022-08-10T00:00:00.000Z","[17788,1690,750,2056,10211]","[2983,491,3003,999,2279]","Breach,Raze,Sage,Astra,Chamber","Raze,Viper,Omen,Chamber,Fade",1588
76392,34148,"VCT 2022 - South America - Last Chance Qualifier","Breeze",600,"Keyd Stars",5750,"Ninjas in Pyjamas",2,10,13,5,7,0,0,0,5,6,5,7,2,1,1,7,5,6,5,"standard","2022-08-10T00:00:00.000Z","[957,4771,5288,81,277]","[16804,2901,3203,2195,762]","Sova,Viper,Jett,KAY/O,Chamber","Sova,Viper,Jett,KAY/O,Chamber",1588
76363,34139,"VCT 2022 - EMEA - Last Chance Qualifier","Breeze",224,"Team Liquid",4220,"Natus Vincere",2,13,9,6,6,1,0,1,7,3,6,6,1,0,1,6,6,3,7,"standard","2022-08-10T00:00:00.000Z","[750,17788,1690,2056,10211]","[2279,3003,491,999,2983]","Sova,Viper,Jett,Skye,Chamber","Cypher,Sova,Viper,Jett,Skye",1588
76396,34149,"VCT 2022 - South America - Last Chance Qualifier","Haven",683,"9z Team",5747,"TBK Esports",2,12,14,6,6,1,1,0,6,7,6,7,1,1,0,7,6,7,6,"standard","2022-08-10T00:00:00.000Z","[9905,14764,1376,3506,3408]","[2366,9831,2457,1506,5580]","Breach,Raze,Astra,Chamber,Fade","Breach,Omen,Chamber,Neon,Fade",1588
76329,34123,"VCT 2022 - EMEA - Last Chance Qualifier","Ascent",7050,"OG LDN UTD",6656,"M3 Champions",2,8,13,3,9,1,1,0,5,4,3,9,1,1,0,9,3,4,5,"standard","2022-08-10T00:00:00.000Z","[2199,2305,1894,2561,426]","[1964,1081,2528,274,2154]","Sage,Omen,Jett,KAY/O,Fade","Sova,Astra,KAY/O,Chamber,Fade",1588
76395,34149,"VCT 2022 - South America - Last Chance Qualifier","Bind",683,"9z Team",5747,"TBK Esports",1,7,13,5,7,1,1,0,5,7,2,6,1,1,0,6,2,7,5,"standard","2022-08-10T00:00:00.000Z","[14764,9905,1376,3408,3506]","[1506,2457,2366,9831,5580]","Raze,Viper,Brimstone,Skye,Chamber","Raze,Viper,Skye,Astra,Fade",1588
76328,34123,"VCT 2022 - EMEA - Last Chance Qualifier","Icebox",7050,"OG LDN UTD",6656,"M3 Champions",2,15,13,6,6,0,0,0,7,7,8,6,2,1,1,6,8,7,7,"standard","2022-08-10T00:00:00.000Z","[2199,2305,2561,1894,426]","[1964,1081,2154,2528,274]","Viper,Sage,KAY/O,Chamber,Fade","Sova,Viper,Sage,KAY/O,Chamber",1588
76327,34123,"VCT 2022 - EMEA - Last Chance Qualifier","Bind",7050,"OG LDN UTD",6656,"M3 Champions",2,8,13,7,5,0,0,0,1,8,7,5,2,1,1,5,7,8,1,"standard","2022-08-10T00:00:00.000Z","[1894,2199,2305,2561,426]","[274,1081,1964,2154,2528]","Raze,Viper,Astra,KAY/O,Fade","Raze,Viper,Omen,Skye,Fade",1588
76326,34122,"VCT 2022 - South America - Last Chance Qualifier","Bind",5747,"TBK Esports",553,"E-Xolos LAZER",1,18,16,4,8,1,0,1,6,11,12,5,1,0,1,5,12,11,6,"standard","2022-08-09T00:00:00.000Z","[1506,2457,2366,9831,5580]","[3274,3252,1141,2773,14639]","Raze,Viper,Skye,Astra,Fade","Raze,Astra,KAY/O,Chamber,Fade",1588
76325,34122,"VCT 2022 - South America - Last Chance Qualifier","Haven",5747,"TBK Esports",553,"E-Xolos LAZER",2,11,13,6,6,2,1,1,5,7,6,6,0,0,0,6,6,7,5,"standard","2022-08-09T00:00:00.000Z","[2366,9831,2457,1506,5580]","[3274,3252,1141,2773,14639]","Breach,Omen,Chamber,Neon,Fade","Raze,Omen,KAY/O,Chamber,Fade",1588
76324,34122,"VCT 2022 - South America - Last Chance Qualifier","Fracture",5747,"TBK Esports",553,"E-Xolos LAZER",2,13,4,11,1,1,0,1,2,3,11,1,1,0,1,1,11,3,2,"standard","2022-08-09T00:00:00.000Z","[5580,2366,2457,9831,1506]","[1141,3274,3252,2773,14639]","Breach,Raze,Viper,Astra,Chamber","Breach,Raze,Brimstone,Chamber,Fade",1588
76361,34138,"VCT 2022 - EMEA - Last Chance Qualifier","Fracture",520,"BBL Esports",386,"Guild Esports",2,10,13,7,5,1,0,1,3,8,7,5,1,0,1,5,7,8,3,"standard","2022-08-09T00:00:00.000Z","[9642,3152,2864,1852,9643]","[449,406,2321,966,1834]","Breach,Brimstone,Sage,Chamber,Neon","Breach,Raze,Brimstone,KAY/O,Chamber",1588
76221,34082,"VCT 2022 - South America - Last Chance Qualifier","Icebox",5750,"Ninjas in Pyjamas",6025,"FUSION",2,13,5,8,4,1,1,0,5,1,8,4,1,1,0,4,8,1,5,"standard","2022-08-09T00:00:00.000Z","[2901,16804,762,3203,2195]","[321,2915,3265,3578,9394]","Viper,Sage,KAY/O,Chamber,Fade","Sova,Viper,Jett,KAY/O,Chamber",1588
76360,34138,"VCT 2022 - EMEA - Last Chance Qualifier","Haven",520,"BBL Esports",386,"Guild Esports",1,3,13,3,9,1,1,0,3,9,0,4,1,1,0,4,0,9,3,"standard","2022-08-09T00:00:00.000Z","[9642,3152,1852,9643,2864]","[449,406,2321,1834,966]","Breach,Killjoy,Omen,Jett,Fade","Breach,Raze,Omen,Chamber,Fade",1588
76220,34082,"VCT 2022 - South America - Last Chance Qualifier","Breeze",5750,"Ninjas in Pyjamas",6025,"FUSION",2,13,11,7,5,2,1,1,6,6,7,5,0,0,0,5,7,6,6,"standard","2022-08-09T00:00:00.000Z","[16804,2901,3203,2195,762]","[321,2915,3265,3578,9394]","Sova,Viper,Jett,KAY/O,Chamber","Sova,Viper,Jett,KAY/O,Chamber",1588
76332,34124,"VCT 2022 - EMEA - Last Chance Qualifier","Bind",194,"G2 Esports (Inactive)",2597,"Acend",2,13,5,9,3,0,0,0,4,2,9,3,2,1,1,3,9,2,4,"standard","2022-08-09T00:00:00.000Z","[1826,2377,2594,2769,2940]","[691,1268,1403,87,732]","Raze,Viper,Skye,Astra,Chamber","Raze,Viper,Brimstone,Skye,KAY/O",1588
76331,34124,"VCT 2022 - EMEA - Last Chance Qualifier","Haven",194,"G2 Esports (Inactive)",2597,"Acend",2,13,11,5,7,1,1,0,8,4,5,7,1,1,0,7,5,4,8,"standard","2022-08-09T00:00:00.000Z","[2594,1826,2377,2769,2940]","[87,1268,1403,732,691]","Breach,Sova,Killjoy,Astra,Neon","Breach,Killjoy,Omen,Jett,Fade",1588
76330,34124,"VCT 2022 - EMEA - Last Chance Qualifier","Fracture",194,"G2 Esports (Inactive)",2597,"Acend",2,8,13,5,7,1,1,0,3,6,5,7,1,1,0,7,5,6,3,"standard","2022-08-09T00:00:00.000Z","[2377,1826,2769,2594,2940]","[87,1403,1268,732,691]","Breach,Raze,Brimstone,KAY/O,Chamber","Breach,Brimstone,KAY/O,Chamber,Neon",1588
76322,34121,"VCT 2022 - South America - Last Chance Qualifier","Fracture",976,"KRÜ Esports",600,"Keyd Stars",2,13,8,7,5,0,0,0,6,3,7,5,2,1,1,5,7,3,6,"standard","2022-08-08T00:00:00.000Z","[4712,3535,4710,2532,1725]","[957,81,4771,277,5288]","Breach,Brimstone,KAY/O,Chamber,Neon","Breach,Raze,Brimstone,Sage,Chamber",1588
75709,33871,"VCT 2022 - EMEA - Last Chance Qualifier","Icebox",386,"Guild Esports",4220,"Natus Vincere",1,9,13,4,8,1,0,1,4,8,5,5,1,0,1,5,5,8,4,"standard","2022-08-08T00:00:00.000Z","[449,2321,406,966,1834]","[2279,491,2983,999,3003]","Sova,Viper,Sage,KAY/O,Chamber","Viper,Sage,KAY/O,Chamber,Fade",1588
76321,34121,"VCT 2022 - South America - Last Chance Qualifier","Breeze",976,"KRÜ Esports",600,"Keyd Stars",2,13,10,5,7,2,1,1,8,3,5,7,0,0,0,7,5,3,8,"standard","2022-08-08T00:00:00.000Z","[4712,3535,1725,4710,2532]","[957,4771,5288,81,277]","Sova,Viper,Jett,KAY/O,Chamber","Sova,Viper,Jett,Skye,Chamber",1588
75708,33871,"VCT 2022 - EMEA - Last Chance Qualifier","Split",386,"Guild Esports",4220,"Natus Vincere",1,13,11,6,6,1,1,0,6,6,7,5,1,1,0,5,7,6,6,"standard","2022-08-08T00:00:00.000Z","[406,1834,449,2321,966]","[2983,491,3003,999,2279]","Raze,Viper,Sage,Astra,KAY/O","Raze,Viper,Omen,Chamber,Fade",1588
76218,34081,"VCT 2022 - South America - Last Chance Qualifier","Bind",683,"9z Team",1264,"FURIA",2,3,13,1,11,1,1,0,2,2,1,11,1,1,0,11,1,2,2,"standard","2022-08-08T00:00:00.000Z","[14764,9905,1376,3408,3506]","[2423,2749,6039,6038,2752]","Raze,Viper,Brimstone,Skye,Chamber","Raze,Brimstone,Skye,Chamber,Fade",1588
76217,34081,"VCT 2022 - South America - Last Chance Qualifier","Ascent",683,"9z Team",1264,"FURIA",2,7,13,4,8,0,0,0,3,5,4,8,2,1,1,8,4,5,3,"standard","2022-08-08T00:00:00.000Z","[3408,3506,1376,14764,9905]","[2752,2423,2749,6038,6039]","Sova,Killjoy,Omen,Jett,KAY/O","Sova,Killjoy,Omen,Jett,KAY/O",1588
75707,33871,"VCT 2022 - EMEA - Last Chance Qualifier","Haven",386,"Guild Esports",4220,"Natus Vincere",1,11,13,4,8,1,0,1,4,8,7,5,1,0,1,5,7,8,4,"standard","2022-08-08T00:00:00.000Z","[449,966,2321,406,1834]","[2279,2983,491,999,3003]","Breach,Sova,Omen,Jett,Chamber","Breach,Raze,Omen,Chamber,Fade",1588
75705,33870,"VCT 2022 - EMEA - Last Chance Qualifier","Icebox",224,"Team Liquid",520,"BBL Esports",1,13,1,11,1,2,1,1,11,1,2,0,0,0,0,0,2,1,11,"standard","2022-08-08T00:00:00.000Z","[1690,17788,750,10211,2056]","[2864,9642,3152,1852,9643]","Raze,Viper,Sage,Chamber,Fade","Sova,Viper,Sage,KAY/O,Chamber",1588
75704,33870,"VCT 2022 - EMEA - Last Chance Qualifier","Ascent",224,"Team Liquid",520,"BBL Esports",2,13,11,5,7,2,1,1,8,4,5,7,0,0,0,7,5,4,8,"standard","2022-08-08T00:00:00.000Z","[1690,750,17788,10211,2056]","[3152,9642,9643,1852,2864]","Phoenix,Omen,KAY/O,Chamber,Fade","Killjoy,Omen,Jett,KAY/O,Fade",1588
76095,34032,"VCT 2022 - North America - Last Chance Qualifier","Icebox",1448,"Evil Geniuses",116,"NRG Esports",2,12,14,5,7,1,1,0,7,6,5,8,1,1,0,8,5,6,7,"standard","2022-08-07T00:00:00.000Z","[2882,3842,11672,4157,1023]","[1597,1232,10253,165,1763]","Sova,Viper,Sage,KAY/O,Chamber","Sova,Viper,Sage,KAY/O,Chamber",1588
76094,34032,"VCT 2022 - North America - Last Chance Qualifier","Bind",1448,"Evil Geniuses",116,"NRG Esports",1,6,13,6,6,1,1,0,6,6,0,7,1,1,0,7,0,6,6,"standard","2022-08-07T00:00:00.000Z","[2882,4157,3842,1023,11672]","[165,1763,10253,1232,1597]","Breach,Raze,Brimstone,Chamber,Fade","Raze,Sage,Skye,Astra,Fade",1588
76090,34030,"VCT 2022 - North America - Last Chance Qualifier","Ascent",617,"FaZe Clan",305,"100 Thieves",1,13,9,3,9,1,0,1,3,9,10,0,1,0,1,0,10,9,3,"standard","2022-08-07T00:00:00.000Z","[1689,1994,369,1990,789]","[122,1012,763,2354,269]","Sova,Omen,Jett,KAY/O,Chamber","Sage,Omen,KAY/O,Chamber,Fade",1588
76089,34030,"VCT 2022 - North America - Last Chance Qualifier","Breeze",617,"FaZe Clan",305,"100 Thieves",1,8,13,4,8,0,0,0,4,8,4,5,2,1,1,5,4,8,4,"standard","2022-08-07T00:00:00.000Z","[1689,1994,369,1990,789]","[122,269,1012,2354,763]","Sova,Viper,Jett,KAY/O,Chamber","Cypher,Sova,Viper,Jett,KAY/O",1588
75563,33811,"VCT 2022 - South America - Last Chance Qualifier","Ascent",976,"KRÜ Esports",5747,"TBK Esports",2,14,12,8,4,1,0,1,5,8,9,4,1,0,1,4,9,8,5,"standard","2022-08-07T00:00:00.000Z","[2532,3535,1725,4710,4712]","[5580,2457,2366,9831,1506]","Killjoy,Omen,Jett,KAY/O,Fade","Sova,Killjoy,Sage,Omen,Jett",1588
76088,34030,"VCT 2022 - North America - Last Chance Qualifier","Haven",617,"FaZe Clan",305,"100 Thieves",1,13,6,8,4,1,0,1,8,4,5,2,1,0,1,2,5,4,8,"standard","2022-08-07T00:00:00.000Z","[369,1689,1994,789,1990]","[763,122,1012,2354,269]","Raze,Sage,Omen,Chamber,Fade","Raze,Sage,Omen,Chamber,Fade",1588
75562,33811,"VCT 2022 - South America - Last Chance Qualifier","Haven",976,"KRÜ Esports",5747,"TBK Esports",2,4,13,3,9,0,0,0,1,4,3,9,2,1,1,9,3,4,1,"standard","2022-08-07T00:00:00.000Z","[4712,1725,3535,2532,4710]","[2366,9831,2457,1506,5580]","Breach,Raze,Astra,Chamber,Fade","Breach,Omen,Chamber,Neon,Fade",1588
75561,33811,"VCT 2022 - South America - Last Chance Qualifier","Breeze",976,"KRÜ Esports",5747,"TBK Esports",1,13,5,8,4,2,1,1,8,4,5,1,0,0,0,1,5,4,8,"standard","2022-08-07T00:00:00.000Z","[4712,3535,1725,4710,2532]","[2366,9831,1506,5580,2457]","Sova,Viper,Jett,KAY/O,Chamber","Sova,Viper,Jett,KAY/O,Chamber",1588
75703,33869,"VCT 2022 - EMEA - Last Chance Qualifier","Fracture",6656,"M3 Champions",2597,"Acend",2,13,6,8,4,1,1,0,5,2,8,4,1,1,0,4,8,2,5,"standard","2022-08-07T00:00:00.000Z","[1964,2528,1081,274,2154]","[87,1403,1268,732,691]","Astra,KAY/O,Chamber,Neon,Fade","Breach,Brimstone,KAY/O,Chamber,Neon",1588
75565,33812,"VCT 2022 - South America - Last Chance Qualifier","Fracture",600,"Keyd Stars",553,"E-Xolos LAZER",2,13,6,10,2,1,0,1,3,4,10,2,1,0,1,2,10,4,3,"standard","2022-08-07T00:00:00.000Z","[957,81,4771,277,5288]","[1141,3274,3252,2773,14639]","Breach,Raze,Brimstone,Sage,Chamber","Breach,Raze,Brimstone,Chamber,Fade",1588
75702,33869,"VCT 2022 - EMEA - Last Chance Qualifier","Breeze",6656,"M3 Champions",2597,"Acend",1,13,10,7,5,1,0,1,7,5,6,5,1,0,1,5,6,5,7,"standard","2022-08-07T00:00:00.000Z","[1081,1964,2154,274,2528]","[87,1268,691,732,1403]","Cypher,Sova,Viper,Jett,KAY/O","Sova,Viper,Omen,Jett,Skye",1588
75564,33812,"VCT 2022 - South America - Last Chance Qualifier","Bind",600,"Keyd Stars",553,"E-Xolos LAZER",1,13,11,7,5,1,1,0,7,5,6,6,1,1,0,6,6,5,7,"standard","2022-08-07T00:00:00.000Z","[81,277,4771,957,5288]","[3274,3252,1141,2773,14639]","Raze,Viper,Brimstone,Skye,Chamber","Raze,Astra,KAY/O,Chamber,Fade",1588
75701,33869,"VCT 2022 - EMEA - Last Chance Qualifier","Split",6656,"M3 Champions",2597,"Acend",2,9,13,6,6,1,0,1,3,7,6,6,1,0,1,6,6,7,3,"standard","2022-08-07T00:00:00.000Z","[1081,1964,2154,2528,274]","[87,691,1268,1403,732]","Viper,Omen,Skye,KAY/O,Chamber","Breach,Raze,Cypher,Omen,Chamber",1588
75699,33868,"VCT 2022 - EMEA - Last Chance Qualifier","Ascent",194,"G2 Esports (Inactive)",7050,"OG LDN UTD",1,6,13,4,8,2,1,1,4,8,2,5,0,0,0,5,2,8,4,"standard","2022-08-07T00:00:00.000Z","[1826,2769,2594,2940,2377]","[2199,2305,2561,1894,426]","Raze,Astra,KAY/O,Chamber,Fade","Sage,Omen,KAY/O,Chamber,Fade",1588
75698,33868,"VCT 2022 - EMEA - Last Chance Qualifier","Haven",194,"G2 Esports (Inactive)",7050,"OG LDN UTD",2,5,13,4,8,1,0,1,1,5,4,8,1,0,1,8,4,5,1,"standard","2022-08-07T00:00:00.000Z","[2594,1826,2377,2769,2940]","[2199,2561,2305,1894,426]","Breach,Sova,Killjoy,Astra,Neon","Breach,Raze,Astra,Chamber,Fade",1588
76071,34024,"VCT 2022 - APAC - Last Chance Qualifier","Icebox",15,"BOOM Esports",667,"Onic Esports",2,13,11,4,8,2,1,1,9,3,4,8,0,0,0,8,4,3,9,"standard","2022-08-07T00:00:00.000Z","[386,217,3365,1919,3363]","[9970,3583,3496,3377,3380]","Sova,Killjoy,Viper,Sage,Chamber","Sova,Viper,Sage,Jett,Chamber",1588
76070,34024,"VCT 2022 - APAC - Last Chance Qualifier","Fracture",15,"BOOM Esports",667,"Onic Esports",1,11,13,5,7,2,1,1,5,7,6,6,0,0,0,6,6,7,5,"standard","2022-08-07T00:00:00.000Z","[3365,1919,386,217,3363]","[9970,3496,3380,3583,3377]","Breach,Brimstone,KAY/O,Chamber,Neon","Breach,Brimstone,KAY/O,Chamber,Neon",1588
76069,34024,"VCT 2022 - APAC - Last Chance Qualifier","Haven",15,"BOOM Esports",667,"Onic Esports",2,14,12,8,4,1,0,1,5,8,9,4,1,0,1,4,9,8,5,"standard","2022-08-07T00:00:00.000Z","[3365,386,217,3363,1919]","[3583,3380,3496,9970,3377]","Breach,Sova,Killjoy,Jett,Astra","Sova,Omen,KAY/O,Chamber,Neon",1588
76068,34024,"VCT 2022 - APAC - Last Chance Qualifier","Bind",15,"BOOM Esports",667,"Onic Esports",1,13,10,6,6,1,0,1,6,6,7,4,1,0,1,4,7,6,6,"standard","2022-08-07T00:00:00.000Z","[386,217,3363,3365,1919]","[3377,9970,3583,3496,3380]","Raze,Viper,Skye,Astra,Fade","Raze,Sova,Viper,Astra,Chamber",1588
76092,34031,"VCT 2022 - North America - Last Chance Qualifier","Fracture",388,"Sentinels",7510,"Shopify Rebellion",2,17,15,5,7,2,1,1,10,6,7,9,0,0,0,9,7,6,10,"standard","2022-08-06T00:00:00.000Z","[893,16735,724,3033,440]","[2489,3345,1522,905,1801]","Breach,Brimstone,KAY/O,Chamber,Neon","Breach,Brimstone,KAY/O,Chamber,Neon",1588
76091,34031,"VCT 2022 - North America - Last Chance Qualifier","Breeze",388,"Sentinels",7510,"Shopify Rebellion",1,13,8,5,7,1,0,1,5,7,8,1,1,0,1,1,8,7,5,"standard","2022-08-06T00:00:00.000Z","[893,16735,440,3033,724]","[2489,3345,1801,1522,905]","Sova,Viper,KAY/O,Chamber,Fade","Sova,Viper,Yoru,KAY/O,Chamber",1588
76086,34029,"VCT 2022 - North America - Last Chance Qualifier","Ascent",5201,"The Guard",141,"Cloud9",1,13,11,7,5,1,0,1,7,5,6,6,1,0,1,6,6,5,7,"standard","2022-08-06T00:00:00.000Z","[4141,1804,2551,1091,11412]","[4639,13591,2213,3599,3773]","Killjoy,Omen,Jett,KAY/O,Fade","Omen,KAY/O,Chamber,Neon,Fade",1588
75559,33810,"VCT 2022 - South America - Last Chance Qualifier","Fracture",6025,"FUSION",1264,"FURIA",1,7,13,6,6,0,0,0,6,6,1,7,2,1,1,7,1,6,6,"standard","2022-08-06T00:00:00.000Z","[2471,321,9394,3578,3265]","[2752,2749,6039,2423,6038]","Breach,Raze,Brimstone,Sage,Chamber","Breach,Brimstone,Sage,Chamber,Neon",1588
76085,34029,"VCT 2022 - North America - Last Chance Qualifier","Fracture",5201,"The Guard",141,"Cloud9",1,13,9,5,7,2,1,1,5,7,8,2,0,0,0,2,8,7,5,"standard","2022-08-06T00:00:00.000Z","[4141,1804,2551,1091,11412]","[3599,3773,4639,2213,13591]","Breach,Brimstone,Jett,Chamber,Fade","Raze,Viper,Omen,Chamber,Fade",1588
75558,33810,"VCT 2022 - South America - Last Chance Qualifier","Ascent",6025,"FUSION",1264,"FURIA",2,7,13,4,8,1,1,0,3,5,4,8,1,1,0,8,4,5,3,"standard","2022-08-06T00:00:00.000Z","[9394,3265,3578,2471,321]","[2752,2423,2749,6038,6039]","Omen,Jett,KAY/O,Chamber,Fade","Sova,Killjoy,Omen,Jett,KAY/O",1588
75557,33809,"VCT 2022 - South America - Last Chance Qualifier","Fracture",5750,"Ninjas in Pyjamas",683,"9z Team",1,12,14,8,4,0,0,0,8,5,4,9,2,1,1,9,4,5,8,"standard","2022-08-06T00:00:00.000Z","[2901,16804,3203,2195,762]","[9905,14764,1376,3408,3506]","Brimstone,KAY/O,Chamber,Neon,Fade","Breach,Raze,Brimstone,Sage,Chamber",1588
75556,33809,"VCT 2022 - South America - Last Chance Qualifier","Ascent",5750,"Ninjas in Pyjamas",683,"9z Team",1,13,4,9,3,2,1,1,9,3,4,1,0,0,0,1,4,3,9,"standard","2022-08-06T00:00:00.000Z","[16804,762,2901,3203,2195]","[14764,1376,9905,3506,3408]","Sova,Killjoy,Omen,Jett,Fade","Raze,Omen,KAY/O,Chamber,Fade",1588
75555,33809,"VCT 2022 - South America - Last Chance Qualifier","Haven",5750,"Ninjas in Pyjamas",683,"9z Team",2,8,13,4,8,1,1,0,4,5,4,8,1,1,0,8,4,5,4,"standard","2022-08-06T00:00:00.000Z","[2901,16804,762,3203,2195]","[9905,14764,1376,3506,3408]","Omen,Skye,KAY/O,Chamber,Neon","Breach,Raze,Astra,Chamber,Fade",1588
76067,34023,"VCT 2022 - APAC - Last Chance Qualifier","Haven",4838,"Bleed Esports",667,"Onic Esports",2,12,14,7,5,1,0,1,5,8,7,6,1,0,1,6,7,8,5,"standard","2022-08-06T00:00:00.000Z","[645,6625,954,7877,6639]","[3583,3380,3496,9970,3377]","Breach,Sova,Killjoy,Omen,Jett","Sova,Omen,KAY/O,Chamber,Neon",1588
76066,34023,"VCT 2022 - APAC - Last Chance Qualifier","Icebox",4838,"Bleed Esports",667,"Onic Esports",1,10,13,6,6,1,1,0,6,6,4,7,1,1,0,7,4,6,6,"standard","2022-08-06T00:00:00.000Z","[6625,645,7877,954,6639]","[9970,3583,3496,3377,3380]","Sova,Killjoy,Viper,Sage,Chamber","Sova,Viper,Sage,Jett,Chamber",1588
76065,34023,"VCT 2022 - APAC - Last Chance Qualifier","Ascent",4838,"Bleed Esports",667,"Onic Esports",1,13,10,7,5,1,1,0,7,5,6,5,1,1,0,5,6,5,7,"standard","2022-08-06T00:00:00.000Z","[954,7877,6639,645,6625]","[3377,3496,3380,3583,9970]","Sage,Omen,Jett,KAY/O,Fade","Jett,Astra,KAY/O,Chamber,Fade",1588
76064,34022,"VCT 2022 - APAC - Last Chance Qualifier","Breeze",4696,"Team Secret",667,"Onic Esports",1,11,13,5,7,1,1,0,5,7,6,6,1,1,0,6,6,7,5,"standard","2022-08-06T00:00:00.000Z","[405,3076,193,9537,2121]","[9970,3380,3377,3496,3583]","Sova,Viper,Jett,Skye,Chamber","Sova,Viper,Jett,Skye,Chamber",1588
76063,34022,"VCT 2022 - APAC - Last Chance Qualifier","Haven",4696,"Team Secret",667,"Onic Esports",1,13,11,6,6,1,1,0,6,6,7,5,1,1,0,5,7,6,6,"standard","2022-08-06T00:00:00.000Z","[9537,405,2674,3076,193]","[3583,3380,3496,9970,3377]","Breach,Sova,Killjoy,Omen,Jett","Sova,Omen,KAY/O,Chamber,Neon",1588
76062,34022,"VCT 2022 - APAC - Last Chance Qualifier","Fracture",4696,"Team Secret",667,"Onic Esports",1,11,13,4,8,0,0,0,4,8,7,5,2,1,1,5,7,8,4,"standard","2022-08-06T00:00:00.000Z","[405,193,3076,9537,2121]","[9970,3496,3380,3583,3377]","Breach,Raze,Brimstone,KAY/O,Chamber","Breach,Brimstone,KAY/O,Chamber,Neon",1588
75129,33622,"VCT 2022 - North America - Last Chance Qualifier","Fracture",7510,"Shopify Rebellion",141,"Cloud9",1,15,17,7,5,1,1,0,8,8,7,9,1,1,0,9,7,8,8,"standard","2022-08-06T00:00:00.000Z","[2489,3345,1522,905,1801]","[3599,3773,4639,2213,13591]","Breach,Brimstone,KAY/O,Chamber,Neon","Raze,Viper,Omen,Chamber,Fade",1588
75128,33622,"VCT 2022 - North America - Last Chance Qualifier","Ascent",7510,"Shopify Rebellion",141,"Cloud9",1,10,13,6,6,1,0,1,6,6,4,7,1,0,1,7,4,6,6,"standard","2022-08-05T00:00:00.000Z","[1522,3345,1801,905,2489]","[4639,13591,2213,3599,3773]","Sage,Omen,KAY/O,Chamber,Fade","Omen,KAY/O,Chamber,Neon,Fade",1588
75136,33624,"VCT 2022 - North America - Last Chance Qualifier","Ascent",116,"NRG Esports",305,"100 Thieves",2,11,13,6,6,2,1,1,5,7,6,6,0,0,0,6,6,7,5,"standard","2022-08-05T00:00:00.000Z","[10253,1232,165,1763,1597]","[122,1012,763,2354,269]","Sova,Astra,KAY/O,Chamber,Fade","Sage,Omen,KAY/O,Chamber,Fade",1588
75135,33624,"VCT 2022 - North America - Last Chance Qualifier","Bind",116,"NRG Esports",305,"100 Thieves",2,7,13,5,7,0,0,0,2,6,5,7,2,1,1,7,5,6,2,"standard","2022-08-05T00:00:00.000Z","[165,1232,1763,10253,1597]","[2354,122,1012,763,269]","Raze,Brimstone,Sage,Skye,Fade","Raze,Viper,Brimstone,Skye,Fade",1588
75134,33624,"VCT 2022 - North America - Last Chance Qualifier","Icebox",116,"NRG Esports",305,"100 Thieves",1,13,11,6,6,0,0,0,6,6,7,5,2,1,1,5,7,6,6,"standard","2022-08-05T00:00:00.000Z","[1597,1232,10253,165,1763]","[269,1012,122,763,2354]","Sova,Viper,Sage,KAY/O,Chamber","Sova,Viper,Sage,KAY/O,Chamber",1588
75932,33968,"VCT 2022 - APAC - Last Chance Qualifier","Haven",15,"BOOM Esports",4838,"Bleed Esports",2,13,7,7,5,2,1,1,6,2,7,5,0,0,0,5,7,2,6,"standard","2022-08-05T00:00:00.000Z","[3365,386,217,3363,1919]","[645,6625,954,7877,6639]","Breach,Sova,Killjoy,Jett,Astra","Breach,Sova,Killjoy,Omen,Jett",1588
75931,33968,"VCT 2022 - APAC - Last Chance Qualifier","Bind",15,"BOOM Esports",4838,"Bleed Esports",1,11,13,8,4,1,1,0,8,4,3,9,1,1,0,9,3,4,8,"standard","2022-08-05T00:00:00.000Z","[386,217,3363,3365,1919]","[6639,645,954,7877,6625]","Raze,Viper,Skye,Astra,Fade","Raze,Viper,Skye,Astra,Fade",1588
75930,33968,"VCT 2022 - APAC - Last Chance Qualifier","Breeze",15,"BOOM Esports",4838,"Bleed Esports",2,13,11,4,8,1,1,0,9,3,4,8,1,1,0,8,4,3,9,"standard","2022-08-05T00:00:00.000Z","[1919,3365,3363,217,386]","[6625,645,954,7877,6639]","Sova,Viper,Jett,KAY/O,Chamber","Sova,Viper,Skye,Astra,Chamber",1588
76018,34007,"VCT 2022 - APAC - Last Chance Qualifier","Icebox",667,"Onic Esports",93,"Made in Thailand",2,13,11,6,6,1,1,0,7,5,6,6,1,1,0,6,6,5,7,"standard","2022-08-05T00:00:00.000Z","[9970,3583,3496,3377,3380]","[609,2582,2957,2071,157]","Sova,Viper,Sage,Jett,Chamber","Sova,Viper,Sage,KAY/O,Chamber",1588
76017,34007,"VCT 2022 - APAC - Last Chance Qualifier","Breeze",667,"Onic Esports",93,"Made in Thailand",2,13,11,4,8,1,1,0,9,3,4,8,1,1,0,8,4,3,9,"standard","2022-08-05T00:00:00.000Z","[9970,3380,3377,3496,3583]","[609,2582,157,2071,2957]","Sova,Viper,Jett,Skye,Chamber","Sova,Viper,Jett,Skye,Chamber",1588
76016,34006,"VCT 2022 - APAC - Last Chance Qualifier","Breeze",4696,"Team Secret",101,"ORDER",1,13,11,8,4,1,1,0,8,4,5,7,1,1,0,7,5,4,8,"standard","2022-08-05T00:00:00.000Z","[405,3076,193,9537,2121]","[40,1046,2691,2271,824]","Sova,Viper,Jett,Skye,Chamber","Sova,Viper,Jett,KAY/O,Chamber",1588
76015,34006,"VCT 2022 - APAC - Last Chance Qualifier","Ascent",4696,"Team Secret",101,"ORDER",1,5,13,3,9,0,0,0,3,9,2,4,2,1,1,4,2,9,3,"standard","2022-08-05T00:00:00.000Z","[2674,193,3076,9537,405]","[824,1046,2271,2691,40]","Killjoy,Jett,Astra,KAY/O,Fade","Raze,Omen,KAY/O,Chamber,Fade",1588
76014,34006,"VCT 2022 - APAC - Last Chance Qualifier","Icebox",4696,"Team Secret",101,"ORDER",2,13,5,9,3,1,1,0,4,2,9,3,1,1,0,3,9,2,4,"standard","2022-08-05T00:00:00.000Z","[3076,2674,193,2121,405]","[824,2271,1046,2691,40]","Viper,Sage,Jett,Chamber,Fade","Killjoy,Viper,Sage,Chamber,Fade",1588
75133,33623,"VCT 2022 - North America - Last Chance Qualifier","Ascent",617,"FaZe Clan",1448,"Evil Geniuses",1,19,17,6,6,0,0,0,11,7,8,10,2,1,1,10,8,7,11,"standard","2022-08-05T00:00:00.000Z","[1689,1994,369,1990,789]","[2882,1023,3842,11672,4157]","Sova,Omen,Jett,KAY/O,Chamber","Killjoy,Phoenix,Astra,KAY/O,Fade",1588
75132,33623,"VCT 2022 - North America - Last Chance Qualifier","Breeze",617,"FaZe Clan",1448,"Evil Geniuses",1,15,13,4,8,1,1,0,6,8,9,5,1,1,0,5,9,8,6,"standard","2022-08-05T00:00:00.000Z","[1689,1994,369,1990,789]","[2882,3842,11672,1023,4157]","Sova,Viper,Jett,KAY/O,Chamber","Sova,Viper,KAY/O,Chamber,Neon",1588
75131,33623,"VCT 2022 - North America - Last Chance Qualifier","Icebox",617,"FaZe Clan",1448,"Evil Geniuses",1,11,13,8,4,0,0,0,8,4,3,9,2,1,1,9,3,4,8,"standard","2022-08-05T00:00:00.000Z","[369,1689,1994,1990,789]","[2882,3842,11672,4157,1023]","Raze,Sova,Viper,KAY/O,Chamber","Sova,Viper,Sage,KAY/O,Chamber",1588
75127,33621,"VCT 2022 - North America - Last Chance Qualifier","Icebox",5201,"The Guard",388,"Sentinels",1,15,13,7,5,0,0,0,8,6,7,7,2,1,1,7,7,6,8,"standard","2022-08-04T00:00:00.000Z","[4141,1091,1804,2551,11412]","[893,16735,724,440,3033]","Viper,Brimstone,KAY/O,Chamber,Fade","Sova,Viper,Sage,KAY/O,Chamber",1588
75126,33621,"VCT 2022 - North America - Last Chance Qualifier","Ascent",5201,"The Guard",388,"Sentinels",1,13,10,6,6,1,0,1,6,6,7,4,1,0,1,4,7,6,6,"standard","2022-08-04T00:00:00.000Z","[4141,1804,2551,1091,11412]","[893,16735,440,3033,724]","Killjoy,Omen,Jett,KAY/O,Fade","Sova,Astra,KAY/O,Chamber,Fade",1588
75125,33621,"VCT 2022 - North America - Last Chance Qualifier","Breeze",5201,"The Guard",388,"Sentinels",2,13,15,5,7,1,1,0,7,7,6,8,1,1,0,8,6,7,7,"standard","2022-08-04T00:00:00.000Z","[11412,1804,2551,1091,4141]","[893,16735,440,3033,724]","Sova,Viper,Jett,KAY/O,Chamber","Sova,Viper,KAY/O,Chamber,Fade",1588
75884,33952,"VCT 2022 - APAC - Last Chance Qualifier","Bind",493,"Alter Ego",93,"Made in Thailand",1,12,14,5,7,1,1,0,5,8,7,6,1,1,0,6,7,8,5,"standard","2022-08-04T00:00:00.000Z","[9957,25261,956,25260,3358]","[609,2957,2582,2071,157]","Raze,Brimstone,Skye,Chamber,Fade","Raze,Viper,Brimstone,Skye,Chamber",1588
75883,33952,"VCT 2022 - APAC - Last Chance Qualifier","Fracture",493,"Alter Ego",93,"Made in Thailand",2,9,13,5,7,2,1,1,4,6,5,7,0,0,0,7,5,6,4,"standard","2022-08-04T00:00:00.000Z","[956,25261,3358,25260,9957]","[2071,2582,609,2957,157]","Breach,Brimstone,KAY/O,Chamber,Neon","Breach,Brimstone,Sage,Chamber,Neon",1588
75882,33952,"VCT 2022 - APAC - Last Chance Qualifier","Haven",493,"Alter Ego",93,"Made in Thailand",2,16,14,9,3,0,0,0,6,9,10,5,2,1,1,5,10,9,6,"standard","2022-08-04T00:00:00.000Z","[956,3358,25261,25260,9957]","[2071,609,2582,2957,157]","Breach,Cypher,Brimstone,Skye,Neon","Breach,Sova,Omen,Chamber,Neon",1588
75880,33951,"VCT 2022 - APAC - Last Chance Qualifier","Ascent",101,"ORDER",225,"CERBERUS Esports",2,13,2,11,1,1,0,1,2,1,11,1,1,0,1,1,11,1,2,"standard","2022-08-04T00:00:00.000Z","[824,1046,2271,2691,40]","[4844,13639,13794,917,12]","Raze,Omen,KAY/O,Chamber,Fade","Raze,Astra,KAY/O,Chamber,Fade",1588
75879,33951,"VCT 2022 - APAC - Last Chance Qualifier","Breeze",101,"ORDER",225,"CERBERUS Esports",1,13,5,7,5,2,1,1,7,5,6,0,0,0,0,0,6,5,7,"standard","2022-08-04T00:00:00.000Z","[40,1046,2691,2271,824]","[12,13639,4844,13794,917]","Sova,Viper,Jett,KAY/O,Chamber","Sova,Viper,Jett,Skye,Chamber",1588
75740,33891,"VCT 2022 - APAC - Last Chance Qualifier","Bind",4838,"Bleed Esports",4696,"Team Secret",1,13,5,9,3,1,0,1,9,3,4,2,1,0,1,2,4,3,9,"standard","2022-08-04T00:00:00.000Z","[6639,645,954,7877,6625]","[193,2674,3076,9537,405]","Raze,Viper,Skye,Astra,Fade","Raze,Viper,Brimstone,Skye,Fade",1588
75739,33891,"VCT 2022 - APAC - Last Chance Qualifier","Icebox",4838,"Bleed Esports",4696,"Team Secret",1,13,6,9,3,2,1,1,9,3,4,3,0,0,0,3,4,3,9,"standard","2022-08-04T00:00:00.000Z","[6625,645,7877,954,6639]","[3076,2674,193,2121,405]","Sova,Killjoy,Viper,Sage,Chamber","Viper,Sage,Jett,Chamber,Fade",1588
75737,33890,"VCT 2022 - APAC - Last Chance Qualifier","Fracture",667,"Onic Esports",15,"BOOM Esports",2,17,19,6,6,1,1,0,9,9,8,10,1,1,0,10,8,9,9,"standard","2022-08-03T00:00:00.000Z","[3380,3496,3583,3377,9970]","[3365,1919,386,217,3363]","Breach,Brimstone,Chamber,Neon,Fade","Breach,Brimstone,KAY/O,Chamber,Neon",1588
75736,33890,"VCT 2022 - APAC - Last Chance Qualifier","Breeze",667,"Onic Esports",15,"BOOM Esports",1,10,13,6,6,1,0,1,6,6,4,7,1,0,1,7,4,6,6,"standard","2022-08-03T00:00:00.000Z","[9970,3380,3377,3496,3583]","[1919,3365,3363,217,386]","Sova,Viper,Jett,Skye,Chamber","Sova,Viper,Jett,KAY/O,Chamber",1588
75735,33889,"VCT 2022 - APAC - Last Chance Qualifier","Fracture",93,"Made in Thailand",3457,"Fancy United Esports",2,13,6,7,5,2,1,1,6,1,7,5,0,0,0,5,7,1,6,"standard","2022-08-03T00:00:00.000Z","[2071,2582,609,2957,157]","[2556,2539,1836,4855,3691]","Breach,Brimstone,Sage,Chamber,Neon","Breach,Brimstone,Astra,KAY/O,Neon",1588
75734,33889,"VCT 2022 - APAC - Last Chance Qualifier","Ascent",93,"Made in Thailand",3457,"Fancy United Esports",2,18,16,7,5,0,0,0,8,9,10,7,2,1,1,7,10,9,8,"standard","2022-08-03T00:00:00.000Z","[609,2957,157,2582,2071]","[3691,2556,1836,2539,4855]","Sova,Killjoy,Jett,Astra,KAY/O","Omen,Astra,KAY/O,Chamber,Fade",1588
75733,33889,"VCT 2022 - APAC - Last Chance Qualifier","Icebox",93,"Made in Thailand",3457,"Fancy United Esports",2,10,13,5,7,0,0,0,5,6,5,7,2,1,1,7,5,6,5,"standard","2022-08-03T00:00:00.000Z","[609,2582,2957,2071,157]","[1836,3691,2556,2539,4855]","Sova,Viper,Sage,KAY/O,Chamber","Viper,Omen,KAY/O,Chamber,Fade",1588
75697,33867,"VCT 2022 - APAC - Last Chance Qualifier","Bind",1643,"Griffin E-Sports",225,"CERBERUS Esports",1,7,13,4,8,2,1,1,4,8,3,5,0,0,0,5,3,8,4,"standard","2022-08-03T00:00:00.000Z","[796,707,3419,1309,2170]","[13794,4844,13639,917,12]","Breach,Raze,Brimstone,Sage,Skye","Breach,Raze,Astra,Chamber,Fade",1588
75696,33867,"VCT 2022 - APAC - Last Chance Qualifier","Breeze",1643,"Griffin E-Sports",225,"CERBERUS Esports",1,11,13,7,5,2,1,1,7,5,4,8,0,0,0,8,4,5,7,"standard","2022-08-03T00:00:00.000Z","[1309,3419,2170,707,796]","[12,13639,4844,13794,917]","Sova,Viper,Jett,KAY/O,Chamber","Sova,Viper,Jett,Skye,Chamber",1588
75695,33867,"VCT 2022 - APAC - Last Chance Qualifier","Haven",1643,"Griffin E-Sports",225,"CERBERUS Esports",2,13,7,7,5,2,1,1,6,2,7,5,0,0,0,5,7,2,6,"standard","2022-08-03T00:00:00.000Z","[707,3419,1309,796,2170]","[13794,4844,13639,917,12]","Breach,Omen,Skye,Chamber,Neon","Breach,Raze,Astra,Chamber,Fade",1588
74847,33458,"VCT 2022 - APAC - Last Chance Qualifier","Haven",4838,"Bleed Esports",493,"Alter Ego",1,13,10,6,6,2,1,1,6,6,7,4,0,0,0,4,7,6,6,"standard","2022-08-02T00:00:00.000Z","[645,6625,954,7877,6639]","[956,3358,25261,25260,9957]","Breach,Sova,Killjoy,Omen,Jett","Breach,Cypher,Brimstone,Skye,Neon",1588
74846,33458,"VCT 2022 - APAC - Last Chance Qualifier","Bind",4838,"Bleed Esports",493,"Alter Ego",1,13,3,10,2,2,1,1,10,2,3,1,0,0,0,1,3,2,10,"standard","2022-08-02T00:00:00.000Z","[6639,645,954,7877,6625]","[9957,25261,956,25260,3358]","Raze,Viper,Skye,Astra,Fade","Raze,Brimstone,Skye,Chamber,Fade",1588
74841,33456,"VCT 2022 - APAC - Last Chance Qualifier","Ascent",667,"Onic Esports",101,"ORDER",1,13,9,7,5,0,0,0,7,5,6,4,2,1,1,4,6,5,7,"standard","2022-08-02T00:00:00.000Z","[3377,3496,3380,3583,9970]","[824,1046,2691,2271,40]","Jett,Astra,KAY/O,Chamber,Fade","Raze,Omen,Jett,KAY/O,Fade",1588
74840,33456,"VCT 2022 - APAC - Last Chance Qualifier","Breeze",667,"Onic Esports",101,"ORDER",1,13,6,7,5,2,1,1,7,5,6,1,0,0,0,1,6,5,7,"standard","2022-08-02T00:00:00.000Z","[9970,3380,3377,3496,3583]","[40,1046,2691,2271,824]","Sova,Viper,Jett,Skye,Chamber","Sova,Viper,Jett,KAY/O,Chamber",1588
74851,33459,"VCT 2022 - APAC - Last Chance Qualifier","Bind",93,"Made in Thailand",4696,"Team Secret",2,9,13,6,6,0,0,0,3,7,6,6,2,1,1,6,6,7,3,"standard","2022-08-02T00:00:00.000Z","[609,2957,2582,2071,157]","[193,2674,3076,9537,405]","Raze,Viper,Brimstone,Skye,Chamber","Raze,Viper,Brimstone,Skye,Fade",1588
74850,33459,"VCT 2022 - APAC - Last Chance Qualifier","Ascent",93,"Made in Thailand",4696,"Team Secret",2,6,13,4,8,1,0,1,2,5,4,8,1,0,1,8,4,5,2,"standard","2022-08-02T00:00:00.000Z","[2957,2582,2071,157,609]","[2674,193,3076,9537,405]","Killjoy,Astra,KAY/O,Chamber,Fade","Killjoy,Jett,Astra,KAY/O,Fade",1588
74849,33459,"VCT 2022 - APAC - Last Chance Qualifier","Haven",93,"Made in Thailand",4696,"Team Secret",2,13,6,6,6,2,1,1,7,0,6,6,0,0,0,6,6,0,7,"standard","2022-08-02T00:00:00.000Z","[2071,609,2582,2957,157]","[9537,405,2674,3076,193]","Breach,Sova,Omen,Chamber,Neon","Breach,Sova,Killjoy,Omen,Jett",1588
74845,33457,"VCT 2022 - APAC - Last Chance Qualifier","Fracture",1643,"Griffin E-Sports",15,"BOOM Esports",2,1,13,1,11,0,0,0,0,2,1,11,2,1,1,11,1,2,0,"standard","2022-08-01T00:00:00.000Z","[707,3419,1309,796,2170]","[3365,1919,386,217,3363]","Breach,Brimstone,KAY/O,Chamber,Neon","Breach,Brimstone,KAY/O,Chamber,Neon",1588
74844,33457,"VCT 2022 - APAC - Last Chance Qualifier","Split",1643,"Griffin E-Sports",15,"BOOM Esports",2,13,10,7,5,1,1,0,6,5,7,5,1,1,0,5,7,5,6,"standard","2022-08-01T00:00:00.000Z","[2170,3419,1309,707,796]","[386,3365,1919,3363,217]","Raze,Viper,Skye,Astra,Chamber","Raze,Viper,Omen,Chamber,Fade",1588
74843,33457,"VCT 2022 - APAC - Last Chance Qualifier","Haven",1643,"Griffin E-Sports",15,"BOOM Esports",1,6,13,5,7,0,0,0,5,7,1,6,2,1,1,6,1,7,5,"standard","2022-08-01T00:00:00.000Z","[707,3419,1309,796,2170]","[3365,386,217,3363,1919]","Breach,Omen,Skye,Chamber,Neon","Breach,Sova,Killjoy,Jett,Astra",1588
74838,33455,"VCT 2022 - APAC - Last Chance Qualifier","Bind",225,"CERBERUS Esports",493,"Alter Ego",2,7,13,5,7,0,0,0,2,6,5,7,2,1,1,7,5,6,2,"standard","2022-08-01T00:00:00.000Z","[4844,13639,13794,917,12]","[9957,25261,956,25260,3358]","Raze,Brimstone,Skye,Chamber,Fade","Raze,Brimstone,Skye,Chamber,Fade",1588
74837,33455,"VCT 2022 - APAC - Last Chance Qualifier","Haven",225,"CERBERUS Esports",493,"Alter Ego",1,10,13,4,8,1,0,1,4,8,6,5,1,0,1,5,6,8,4,"standard","2022-08-01T00:00:00.000Z","[13794,4844,13639,917,12]","[956,3358,25261,25260,9957]","Breach,Raze,Astra,Chamber,Fade","Breach,Cypher,Brimstone,Skye,Neon",1588
74835,33454,"VCT 2022 - APAC - Last Chance Qualifier","Fracture",101,"ORDER",3457,"Fancy United Esports",2,13,6,10,2,1,0,1,3,4,10,2,1,0,1,2,10,4,3,"standard","2022-08-01T00:00:00.000Z","[2271,1046,40,2691,824]","[2556,2539,1836,4855,3691]","Breach,Brimstone,Sage,Chamber,Neon","Breach,Brimstone,Astra,KAY/O,Neon",1588
74834,33454,"VCT 2022 - APAC - Last Chance Qualifier","Ascent",101,"ORDER",3457,"Fancy United Esports",1,13,11,6,6,1,1,0,6,6,7,5,1,1,0,5,7,6,6,"standard","2022-08-01T00:00:00.000Z","[824,1046,2271,2691,40]","[3691,2556,1836,2539,4855]","Raze,Omen,KAY/O,Chamber,Fade","Omen,Astra,KAY/O,Chamber,Fade",1588
74680,33394,"VALORANT Champions Tour 2022 - Stage 2 - Masters Copenhagen - Playoffs","Breeze",184,"Paper Rex",17,"FunPlus Phoenix",1,9,13,5,7,1,0,1,5,7,4,6,1,0,1,6,4,7,5,"standard","2022-07-24T00:00:00.000Z","[8388,8386,8385,432,8387]","[2225,2359,2335,3043,1256]","Breach,Yoru,Astra,Neon,Fade","Cypher,Sova,Viper,Jett,Skye",1588
74679,33394,"VALORANT Champions Tour 2022 - Stage 2 - Masters Copenhagen - Playoffs","Haven",184,"Paper Rex",17,"FunPlus Phoenix",1,13,7,7,5,1,0,1,7,5,6,2,1,0,1,2,6,5,7,"standard","2022-07-24T00:00:00.000Z","[432,8387,8385,8386,8388]","[1256,2225,2335,3043,2359]","Raze,Sage,Astra,Chamber,Fade","Raze,Sage,Omen,Chamber,Fade",1588
74678,33394,"VALORANT Champions Tour 2022 - Stage 2 - Masters Copenhagen - Playoffs","Fracture",184,"Paper Rex",17,"FunPlus Phoenix",1,7,13,6,6,1,1,0,6,6,1,7,1,1,0,7,1,6,6,"standard","2022-07-24T00:00:00.000Z","[8387,432,8385,8388,8386]","[1256,2225,2335,3043,2359]","Breach,Raze,Viper,Chamber,Neon","Raze,Viper,Omen,Chamber,Fade",1588
74677,33394,"VALORANT Champions Tour 2022 - Stage 2 - Masters Copenhagen - Playoffs","Icebox",184,"Paper Rex",17,"FunPlus Phoenix",1,13,7,9,3,2,1,1,9,3,4,4,0,0,0,4,4,3,9,"standard","2022-07-24T00:00:00.000Z","[8385,432,8386,8388,8387]","[2225,2359,1256,3043,2335]","Viper,Sage,Jett,Chamber,Fade","Viper,Sage,KAY/O,Chamber,Fade",1588
74676,33394,"VALORANT Champions Tour 2022 - Stage 2 - Masters Copenhagen - Playoffs","Bind",184,"Paper Rex",17,"FunPlus Phoenix",2,3,13,1,11,0,0,0,2,2,1,11,2,1,1,11,1,2,2,"standard","2022-07-24T00:00:00.000Z","[8387,432,8385,8386,8388]","[1256,2225,2335,2359,3043]","Breach,Raze,Brimstone,Yoru,Fade","Raze,Viper,Brimstone,Sage,KAY/O",1588
74674,33393,"VALORANT Champions Tour 2022 - Stage 2 - Masters Copenhagen - Playoffs","Fracture",6426,"OpTic Gaming",17,"FunPlus Phoenix",2,7,13,3,9,0,0,0,4,4,3,9,2,1,1,9,3,4,4,"standard","2022-07-23T00:00:00.000Z","[2841,398,2483,2716,3211]","[1256,2225,2335,3043,2359]","Breach,Brimstone,KAY/O,Chamber,Neon","Raze,Viper,Omen,Chamber,Fade",1588
74673,33393,"VALORANT Champions Tour 2022 - Stage 2 - Masters Copenhagen - Playoffs","Bind",6426,"OpTic Gaming",17,"FunPlus Phoenix",1,13,6,9,3,2,1,1,9,3,4,3,0,0,0,3,4,3,9,"standard","2022-07-23T00:00:00.000Z","[3211,2841,398,2483,2716]","[1256,2225,2335,3043,2359]","Raze,Viper,Brimstone,Skye,Chamber","Raze,Viper,Brimstone,KAY/O,Fade",1588
74672,33393,"VALORANT Champions Tour 2022 - Stage 2 - Masters Copenhagen - Playoffs","Icebox",6426,"OpTic Gaming",17,"FunPlus Phoenix",1,8,13,6,6,1,1,0,6,6,2,7,1,1,0,7,2,6,6,"standard","2022-07-23T00:00:00.000Z","[2483,2841,398,2716,3211]","[2225,2359,1256,3043,2335]","Sova,Viper,KAY/O,Chamber,Neon","Viper,Sage,KAY/O,Chamber,Fade",1588
74671,33393,"VALORANT Champions Tour 2022 - Stage 2 - Masters Copenhagen - Playoffs","Split",6426,"OpTic Gaming",17,"FunPlus Phoenix",1,6,13,3,9,2,1,1,3,9,3,4,0,0,0,4,3,9,3,"standard","2022-07-23T00:00:00.000Z","[3211,398,2483,2716,2841]","[1256,2225,2335,2359,3043]","Raze,Astra,KAY/O,Chamber,Fade","Raze,Killjoy,Viper,Omen,KAY/O",1588
74311,33219,"VALORANT Champions Tour 2022 - Stage 2 - Masters Copenhagen - Playoffs","Fracture",17,"FunPlus Phoenix",1625,"FNATIC",2,13,5,9,3,1,0,1,4,2,9,3,1,0,1,3,9,2,4,"standard","2022-07-22T00:00:00.000Z","[1256,2225,2335,3043,2359]","[76,14543,718,2011,2937]","Raze,Viper,Omen,Chamber,Fade","Breach,Raze,Viper,Brimstone,Chamber",1588
74310,33219,"VALORANT Champions Tour 2022 - Stage 2 - Masters Copenhagen - Playoffs","Bind",17,"FunPlus Phoenix",1625,"FNATIC",2,13,7,7,5,2,1,1,6,2,7,5,0,0,0,5,7,2,6,"standard","2022-07-22T00:00:00.000Z","[1256,2225,2335,3043,2359]","[2937,14543,76,2011,718]","Raze,Viper,Brimstone,KAY/O,Fade","Raze,Viper,Skye,Astra,Fade",1588
74309,33219,"VALORANT Champions Tour 2022 - Stage 2 - Masters Copenhagen - Playoffs","Split",17,"FunPlus Phoenix",1625,"FNATIC",1,13,15,8,4,1,1,0,8,6,5,9,1,1,0,9,5,6,8,"standard","2022-07-22T00:00:00.000Z","[1256,2225,2335,2359,3043]","[14543,76,2011,2937,718]","Raze,Killjoy,Viper,Astra,KAY/O","Raze,Viper,Omen,Chamber,Fade",1588
74190,33178,"VALORANT Champions Tour 2022 - Stage 2 - Masters Copenhagen - Playoffs","Fracture",184,"Paper Rex",6426,"OpTic Gaming",2,13,5,9,3,1,0,1,4,2,9,3,1,0,1,3,9,2,4,"standard","2022-07-22T00:00:00.000Z","[8387,432,8385,8388,8386]","[2841,398,2483,2716,3211]","Breach,Raze,Viper,Chamber,Neon","Breach,Brimstone,KAY/O,Chamber,Neon",1588
74189,33178,"VALORANT Champions Tour 2022 - Stage 2 - Masters Copenhagen - Playoffs","Bind",184,"Paper Rex",6426,"OpTic Gaming",1,9,13,3,9,0,0,0,3,9,6,4,2,1,1,4,6,9,3,"standard","2022-07-22T00:00:00.000Z","[432,8387,8385,8386,8388]","[3211,2841,398,2483,2716]","Raze,Viper,Brimstone,Chamber,Fade","Raze,Viper,Brimstone,Skye,Chamber",1588
74188,33178,"VALORANT Champions Tour 2022 - Stage 2 - Masters Copenhagen - Playoffs","Haven",184,"Paper Rex",6426,"OpTic Gaming",1,13,3,9,3,1,0,1,9,3,4,0,1,0,1,0,4,3,9,"standard","2022-07-22T00:00:00.000Z","[432,8387,8385,8386,8388]","[2841,398,2483,2716,3211]","Raze,Sage,Astra,Chamber,Fade","Breach,Omen,Skye,Chamber,Neon",1588
74083,33138,"VALORANT Champions Tour 2022 - Stage 2 - Masters Copenhagen - Playoffs","Fracture",286,"DRX",17,"FunPlus Phoenix",2,5,13,3,9,1,1,0,2,4,3,9,1,1,0,9,3,4,2,"standard","2022-07-18T00:00:00.000Z","[452,582,1251,1550,814]","[1256,2225,2335,3043,2359]","Brimstone,KAY/O,Chamber,Neon,Fade","Raze,Viper,Omen,Chamber,Fade",1588
74082,33138,"VALORANT Champions Tour 2022 - Stage 2 - Masters Copenhagen - Playoffs","Ascent",286,"DRX",17,"FunPlus Phoenix",2,9,13,6,6,1,1,0,3,7,6,6,1,1,0,6,6,7,3,"standard","2022-07-18T00:00:00.000Z","[814,452,1550,1251,582]","[2225,2335,3043,1256,2359]","Sova,Astra,KAY/O,Chamber,Fade","Sage,Omen,Jett,KAY/O,Fade",1588
74099,33143,"VALORANT Champions Tour 2022 - Stage 2 - Masters Copenhagen - Playoffs","Bind",1625,"FNATIC",738,"Leviatán",1,17,15,5,7,1,0,1,7,9,10,6,1,0,1,6,10,9,7,"standard","2022-07-18T00:00:00.000Z","[2937,14543,76,2011,718]","[6414,3531,3421,21588,3532]","Raze,Viper,Skye,Astra,Fade","Raze,Viper,Brimstone,Skye,Chamber",1588
74098,33143,"VALORANT Champions Tour 2022 - Stage 2 - Masters Copenhagen - Playoffs","Ascent",1625,"FNATIC",738,"Leviatán",2,10,13,6,6,0,0,0,4,7,6,6,2,1,1,6,6,7,4,"standard","2022-07-18T00:00:00.000Z","[14543,2011,76,2937,718]","[3531,3421,6414,3532,21588]","Sage,Omen,KAY/O,Chamber,Fade","Sova,Astra,KAY/O,Chamber,Fade",1588
74097,33143,"VALORANT Champions Tour 2022 - Stage 2 - Masters Copenhagen - Playoffs","Fracture",1625,"FNATIC",738,"Leviatán",1,14,12,5,7,1,0,1,6,7,8,5,1,0,1,5,8,7,6,"standard","2022-07-18T00:00:00.000Z","[76,14543,718,2011,2937]","[3531,3421,21588,3532,6414]","Breach,Raze,Viper,Brimstone,Chamber","Breach,Brimstone,KAY/O,Chamber,Neon",1588
74033,33115,"VALORANT Champions Tour 2022 - Stage 2 - Masters Copenhagen - Playoffs","Bind",286,"DRX",6426,"OpTic Gaming",1,11,13,4,8,0,0,0,4,8,7,5,2,1,1,5,7,8,4,"standard","2022-07-17T00:00:00.000Z","[1550,452,814,582,1251]","[3211,2841,398,2483,2716]","Raze,Viper,Brimstone,Skye,Chamber","Raze,Viper,Brimstone,Skye,Chamber",1588
74032,33115,"VALORANT Champions Tour 2022 - Stage 2 - Masters Copenhagen - Playoffs","Breeze",286,"DRX",6426,"OpTic Gaming",2,4,13,2,10,1,1,0,2,3,2,10,1,1,0,10,2,3,2,"standard","2022-07-17T00:00:00.000Z","[814,452,1550,582,1251]","[2483,2841,3211,398,2716]","Sova,Viper,Jett,Skye,Chamber","Sova,Viper,Jett,KAY/O,Chamber",1588
74031,33115,"VALORANT Champions Tour 2022 - Stage 2 - Masters Copenhagen - Playoffs","Fracture",286,"DRX",6426,"OpTic Gaming",1,13,4,11,1,2,1,1,11,1,2,3,0,0,0,3,2,1,11,"standard","2022-07-17T00:00:00.000Z","[452,582,1251,1550,814]","[2841,398,2483,2716,3211]","Brimstone,KAY/O,Chamber,Neon,Fade","Breach,Brimstone,KAY/O,Chamber,Neon",1588
73902,33055,"VALORANT Champions Tour 2022 - Stage 2 - Masters Copenhagen - Playoffs","Bind",184,"Paper Rex",1625,"FNATIC",2,13,10,7,5,2,1,1,6,5,7,5,0,0,0,5,7,5,6,"standard","2022-07-17T00:00:00.000Z","[8387,432,8385,8386,8388]","[2937,14543,76,2011,718]","Breach,Raze,Brimstone,Yoru,Fade","Raze,Viper,Skye,Astra,Fade",1588
73901,33055,"VALORANT Champions Tour 2022 - Stage 2 - Masters Copenhagen - Playoffs","Ascent",184,"Paper Rex",1625,"FNATIC",1,13,11,6,6,1,0,1,6,6,7,5,1,0,1,5,7,6,6,"standard","2022-07-17T00:00:00.000Z","[432,8385,8388,8386,8387]","[14543,2011,76,2937,718]","Raze,Astra,KAY/O,Chamber,Fade","Sage,Omen,KAY/O,Chamber,Fade",1588
74036,33116,"VALORANT Champions Tour 2022 - Stage 2 - Masters Copenhagen - Playoffs","Haven",738,"Leviatán",603,"XSET",2,16,14,9,3,1,0,1,4,11,12,3,1,0,1,3,12,11,4,"standard","2022-07-16T00:00:00.000Z","[3531,6414,3421,3532,21588]","[494,3062,3582,3346,1802]","Breach,Raze,Omen,Chamber,Fade","Breach,Omen,Jett,Skye,Chamber",1588
74035,33116,"VALORANT Champions Tour 2022 - Stage 2 - Masters Copenhagen - Playoffs","Ascent",738,"Leviatán",603,"XSET",1,15,13,4,8,2,1,1,5,9,10,4,0,0,0,4,10,9,5,"standard","2022-07-16T00:00:00.000Z","[3531,3421,6414,3532,21588]","[3582,3062,3346,1802,494]","Sova,Astra,KAY/O,Chamber,Fade","Sova,Killjoy,Omen,Jett,KAY/O",1588
74034,33116,"VALORANT Champions Tour 2022 - Stage 2 - Masters Copenhagen - Playoffs","Split",738,"Leviatán",603,"XSET",2,9,13,4,8,2,1,1,5,5,4,8,0,0,0,8,4,5,5,"standard","2022-07-16T00:00:00.000Z","[3531,3421,21588,3532,6414]","[3582,3062,494,3346,1802]","Breach,Astra,KAY/O,Chamber,Neon","Raze,Viper,Sage,Omen,Chamber",1588
73906,33056,"VALORANT Champions Tour 2022 - Stage 2 - Masters Copenhagen - Playoffs","Bind",386,"Guild Esports",17,"FunPlus Phoenix",1,4,13,3,9,0,0,0,3,9,1,4,2,1,1,4,1,9,3,"standard","2022-07-16T00:00:00.000Z","[966,2318,1834,2321,449]","[1256,2225,2335,3043,2359]","Raze,Viper,Skye,Astra,Fade","Raze,Viper,Brimstone,KAY/O,Fade",1588
73905,33056,"VALORANT Champions Tour 2022 - Stage 2 - Masters Copenhagen - Playoffs","Breeze",386,"Guild Esports",17,"FunPlus Phoenix",2,13,3,12,0,1,0,1,1,3,12,0,1,0,1,0,12,3,1,"standard","2022-07-16T00:00:00.000Z","[966,449,2321,1834,2318]","[2359,2225,2335,1256,3043]","Cypher,Sova,Viper,Jett,KAY/O","Sova,Viper,Yoru,KAY/O,Chamber",1588
73904,33056,"VALORANT Champions Tour 2022 - Stage 2 - Masters Copenhagen - Playoffs","Ascent",386,"Guild Esports",17,"FunPlus Phoenix",2,11,13,5,7,1,0,1,6,6,5,7,1,0,1,7,5,6,6,"standard","2022-07-16T00:00:00.000Z","[966,2321,2318,1834,449]","[2225,2335,1256,3043,2359]","Raze,Astra,KAY/O,Chamber,Fade","Sage,Omen,KAY/O,Chamber,Fade",1588
73745,32996,"VALORANT Champions Tour 2022 - Stage 2 - Masters Copenhagen - Playoffs","Bind",603,"XSET",6426,"OpTic Gaming",2,6,13,4,8,0,0,0,2,5,4,8,2,1,1,8,4,5,2,"standard","2022-07-15T00:00:00.000Z","[3582,3062,494,3346,1802]","[3211,2841,398,2483,2716]","Raze,Viper,Brimstone,Skye,Chamber","Raze,Viper,Brimstone,Skye,Chamber",1588
73744,32996,"VALORANT Champions Tour 2022 - Stage 2 - Masters Copenhagen - Playoffs","Haven",603,"XSET",6426,"OpTic Gaming",2,7,13,2,10,1,1,0,5,3,2,10,1,1,0,10,2,3,5,"standard","2022-07-15T00:00:00.000Z","[494,3062,3582,3346,1802]","[2841,398,2483,2716,3211]","Breach,Omen,Jett,Skye,Chamber","Breach,Omen,Skye,Chamber,Neon",1588
73749,32997,"VALORANT Champions Tour 2022 - Stage 2 - Masters Copenhagen - Playoffs","Haven",738,"Leviatán",286,"DRX",2,11,13,3,9,2,1,1,8,4,3,9,0,0,0,9,3,4,8,"standard","2022-07-15T00:00:00.000Z","[3531,6414,3421,3532,21588]","[582,814,1251,452,1550]","Breach,Raze,Omen,Chamber,Fade","Breach,Sova,Killjoy,Omen,Jett",1588
73748,32997,"VALORANT Champions Tour 2022 - Stage 2 - Masters Copenhagen - Playoffs","Breeze",738,"Leviatán",286,"DRX",2,5,13,4,8,0,0,0,1,5,4,8,2,1,1,8,4,5,1,"standard","2022-07-15T00:00:00.000Z","[3531,3421,21588,6414,3532]","[814,452,1550,582,1251]","Sova,Viper,Skye,KAY/O,Chamber","Sova,Viper,Jett,Skye,Chamber",1588
73747,32997,"VALORANT Champions Tour 2022 - Stage 2 - Masters Copenhagen - Playoffs","Ascent",738,"Leviatán",286,"DRX",2,13,6,11,1,1,0,1,2,5,11,1,1,0,1,1,11,5,2,"standard","2022-07-15T00:00:00.000Z","[3531,3421,6414,3532,21588]","[1251,1550,452,582,814]","Sova,Astra,KAY/O,Chamber,Fade","Killjoy,Jett,Astra,KAY/O,Fade",1588
73751,32998,"VALORANT Champions Tour 2022 - Stage 2 - Masters Copenhagen - Playoffs","Haven",1625,"FNATIC",17,"FunPlus Phoenix",1,13,4,10,2,2,1,1,10,2,3,2,0,0,0,2,3,2,10,"standard","2022-07-14T00:00:00.000Z","[76,14543,718,2011,2937]","[1256,1481,2335,3043,2359]","Breach,Raze,Sova,Omen,Chamber","Raze,Omen,KAY/O,Chamber,Fade",1588
73750,32998,"VALORANT Champions Tour 2022 - Stage 2 - Masters Copenhagen - Playoffs","Icebox",1625,"FNATIC",17,"FunPlus Phoenix",1,13,10,4,8,2,1,1,4,8,9,2,0,0,0,2,9,8,4,"standard","2022-07-14T00:00:00.000Z","[718,14543,2011,76,2937]","[1256,1481,2359,3043,2335]","Sova,Killjoy,Viper,Sage,Chamber","Raze,Viper,Sage,Chamber,Fade",1588
73754,32999,"VALORANT Champions Tour 2022 - Stage 2 - Masters Copenhagen - Playoffs","Fracture",184,"Paper Rex",386,"Guild Esports",1,14,12,6,6,2,1,1,7,6,7,6,0,0,0,6,7,6,7,"standard","2022-07-14T00:00:00.000Z","[8387,8385,432,8388,8386]","[449,966,2321,2318,1834]","Breach,Viper,Sage,Chamber,Neon","Breach,Raze,Brimstone,Sage,Chamber",1588
73753,32999,"VALORANT Champions Tour 2022 - Stage 2 - Masters Copenhagen - Playoffs","Ascent",184,"Paper Rex",386,"Guild Esports",1,13,4,8,4,2,1,1,8,4,5,0,0,0,0,0,5,4,8,"standard","2022-07-14T00:00:00.000Z","[432,8385,8388,8386,8387]","[966,2321,2318,1834,449]","Raze,Astra,KAY/O,Chamber,Fade","Raze,Astra,KAY/O,Chamber,Fade",1588
73539,32856,"VALORANT Champions Tour 2022 - Stage 2 - Masters Copenhagen - Group Stage","Haven",976,"KRÜ Esports",6426,"OpTic Gaming",2,6,13,2,10,1,0,1,4,3,2,10,1,0,1,10,2,3,4,"standard","2022-07-13T00:00:00.000Z","[4712,1725,3535,2532,4710]","[2841,398,2483,2716,3211]","Breach,Raze,Omen,Chamber,Fade","Breach,Omen,Skye,Chamber,Neon",1588
73538,32856,"VALORANT Champions Tour 2022 - Stage 2 - Masters Copenhagen - Group Stage","Split",976,"KRÜ Esports",6426,"OpTic Gaming",2,7,13,7,5,1,0,1,0,8,7,5,1,0,1,5,7,8,0,"standard","2022-07-13T00:00:00.000Z","[1725,4712,4710,3535,2532]","[3211,398,2483,2716,2841]","Raze,Viper,Skye,Astra,Chamber","Raze,Astra,KAY/O,Chamber,Fade",1588
73714,32971,"VALORANT Champions Tour 2022 - Stage 2 - Masters Copenhagen - Group Stage","Ascent",17,"FunPlus Phoenix",1840,"NORTHEPTION",1,13,9,9,3,1,1,0,9,3,4,6,1,1,0,6,4,3,9,"standard","2022-07-13T00:00:00.000Z","[1481,2335,1256,3043,2359]","[2272,8882,652,12341,3060]","Sage,Omen,KAY/O,Chamber,Fade","Killjoy,Astra,KAY/O,Chamber,Fade",1588
73713,32971,"VALORANT Champions Tour 2022 - Stage 2 - Masters Copenhagen - Group Stage","Fracture",17,"FunPlus Phoenix",1840,"NORTHEPTION",1,13,9,7,5,1,1,0,7,5,6,4,1,1,0,4,6,5,7,"standard","2022-07-13T00:00:00.000Z","[1256,1481,2335,3043,2359]","[3060,652,8882,12341,2272]","Raze,Viper,Omen,Chamber,Fade","Breach,Raze,Brimstone,Chamber,Neon",1588
73503,32843,"VALORANT Champions Tour 2022 - Stage 2 - Masters Copenhagen - Group Stage","Split",6426,"OpTic Gaming",6344,"LOUD",1,14,12,5,7,1,1,0,6,7,8,5,1,1,0,5,8,7,6,"standard","2022-07-12T00:00:00.000Z","[3211,398,2483,2716,2841]","[2294,4748,4746,6037,2895]","Raze,Astra,KAY/O,Chamber,Fade","Breach,Raze,Viper,Astra,Fade",1588
73502,32843,"VALORANT Champions Tour 2022 - Stage 2 - Masters Copenhagen - Group Stage","Fracture",6426,"OpTic Gaming",6344,"LOUD",2,13,8,8,4,2,1,1,5,4,8,4,0,0,0,4,8,4,5,"standard","2022-07-12T00:00:00.000Z","[2841,398,2483,2716,3211]","[2294,4748,6037,2895,4746]","Breach,Brimstone,KAY/O,Chamber,Neon","Breach,Raze,Brimstone,Sage,Chamber",1588
73501,32843,"VALORANT Champions Tour 2022 - Stage 2 - Masters Copenhagen - Group Stage","Ascent",6426,"OpTic Gaming",6344,"LOUD",2,8,13,6,6,1,0,1,2,7,6,6,1,0,1,6,6,7,2,"standard","2022-07-12T00:00:00.000Z","[2483,398,3211,2716,2841]","[2294,4746,6037,4748,2895]","Sova,Astra,KAY/O,Chamber,Fade","Sova,Killjoy,Omen,Jett,KAY/O",1588
73537,32855,"VALORANT Champions Tour 2022 - Stage 2 - Masters Copenhagen - Group Stage","Bind",5903,"XERXIA Esports",1840,"NORTHEPTION",1,13,15,6,6,2,1,1,7,7,6,8,0,0,0,8,6,7,7,"standard","2022-07-12T00:00:00.000Z","[671,766,3642,6890,21245]","[652,8882,2272,3060,12341]","Raze,Viper,Brimstone,Skye,Chamber","Raze,Viper,Brimstone,Skye,Chamber",1588
73536,32855,"VALORANT Champions Tour 2022 - Stage 2 - Masters Copenhagen - Group Stage","Haven",5903,"XERXIA Esports",1840,"NORTHEPTION",2,8,13,4,8,1,0,1,4,5,4,8,1,0,1,8,4,5,4,"standard","2022-07-12T00:00:00.000Z","[3642,6890,671,21245,766]","[3060,2272,8882,12341,652]","Breach,Sova,Killjoy,Jett,Astra","Breach,Killjoy,Omen,Jett,Skye",1588
73535,32855,"VALORANT Champions Tour 2022 - Stage 2 - Masters Copenhagen - Group Stage","Split",5903,"XERXIA Esports",1840,"NORTHEPTION",2,13,9,8,4,0,0,0,5,5,8,4,2,1,1,4,8,5,5,"standard","2022-07-12T00:00:00.000Z","[3642,671,766,21245,6890]","[3060,2272,8882,12341,652]","Breach,Raze,Omen,Chamber,Fade","Breach,Sage,Omen,Jett,Chamber",1588
73534,32854,"VALORANT Champions Tour 2022 - Stage 2 - Masters Copenhagen - Group Stage","Breeze",17,"FunPlus Phoenix",286,"DRX",2,6,13,3,9,1,0,1,3,4,3,9,1,0,1,9,3,4,3,"standard","2022-07-12T00:00:00.000Z","[1481,2359,1256,3043,2335]","[814,452,1550,582,1251]","Viper,Jett,KAY/O,Chamber,Fade","Sova,Viper,Jett,Skye,Chamber",1588
73533,32854,"VALORANT Champions Tour 2022 - Stage 2 - Masters Copenhagen - Group Stage","Fracture",17,"FunPlus Phoenix",286,"DRX",2,6,13,3,9,1,0,1,3,4,3,9,1,0,1,9,3,4,3,"standard","2022-07-12T00:00:00.000Z","[1256,1481,2335,3043,2359]","[452,582,1251,1550,814]","Raze,Viper,Omen,Chamber,Fade","Brimstone,KAY/O,Chamber,Neon,Fade",1588
73532,32854,"VALORANT Champions Tour 2022 - Stage 2 - Masters Copenhagen - Group Stage","Haven",17,"FunPlus Phoenix",286,"DRX",1,13,8,5,7,1,0,1,5,7,8,1,1,0,1,1,8,7,5,"standard","2022-07-12T00:00:00.000Z","[2335,1256,1481,3043,2359]","[582,814,1251,1550,452]","Breach,Raze,Omen,Chamber,Fade","Breach,Sova,Killjoy,Jett,Astra",1588
73500,32842,"VALORANT Champions Tour 2022 - Stage 2 - Masters Copenhagen - Group Stage","Icebox",386,"Guild Esports",976,"KRÜ Esports",1,16,14,5,7,2,1,1,6,9,10,5,0,0,0,5,10,9,6,"standard","2022-07-11T00:00:00.000Z","[449,2321,2318,966,1834]","[3535,4712,4710,1725,2532]","Sova,Viper,Sage,KAY/O,Chamber","Sova,Viper,Sage,KAY/O,Chamber",1588
73499,32842,"VALORANT Champions Tour 2022 - Stage 2 - Masters Copenhagen - Group Stage","Fracture",386,"Guild Esports",976,"KRÜ Esports",1,13,6,9,3,1,1,0,9,3,4,3,1,1,0,3,4,3,9,"standard","2022-07-11T00:00:00.000Z","[449,966,2321,2318,1834]","[4712,1725,3535,4710,2532]","Breach,Raze,Brimstone,Sage,Chamber","Breach,Raze,Brimstone,Sage,Chamber",1588
73498,32842,"VALORANT Champions Tour 2022 - Stage 2 - Masters Copenhagen - Group Stage","Bind",386,"Guild Esports",976,"KRÜ Esports",2,12,14,7,5,0,0,0,5,8,7,6,2,1,1,6,7,8,5,"standard","2022-07-11T00:00:00.000Z","[966,2318,1834,2321,449]","[1725,4712,3535,4710,2532]","Raze,Viper,Skye,Astra,Fade","Raze,Viper,Brimstone,Skye,Chamber",1588
72450,32352,"VALORANT Champions Tour 2022 - Stage 2 - Masters Copenhagen - Group Stage","Haven",17,"FunPlus Phoenix",5903,"XERXIA Esports",2,13,10,7,5,0,0,0,6,5,7,5,2,1,1,5,7,5,6,"standard","2022-07-11T00:00:00.000Z","[1256,1481,2335,3043,2359]","[3642,671,21245,6890,766]","Raze,Omen,KAY/O,Chamber,Fade","Breach,Killjoy,Jett,Skye,Astra",1588
72449,32352,"VALORANT Champions Tour 2022 - Stage 2 - Masters Copenhagen - Group Stage","Ascent",17,"FunPlus Phoenix",5903,"XERXIA Esports",1,9,13,5,7,2,1,1,5,7,4,6,0,0,0,6,4,7,5,"standard","2022-07-11T00:00:00.000Z","[1481,2335,1256,3043,2359]","[671,21245,766,3642,6890]","Sage,Omen,KAY/O,Chamber,Fade","Killjoy,Jett,Astra,KAY/O,Fade",1588
72448,32352,"VALORANT Champions Tour 2022 - Stage 2 - Masters Copenhagen - Group Stage","Bind",17,"FunPlus Phoenix",5903,"XERXIA Esports",2,14,12,5,7,1,1,0,8,5,6,7,1,1,0,7,6,5,8,"standard","2022-07-11T00:00:00.000Z","[1256,1481,2335,3043,2359]","[671,766,3642,6890,21245]","Raze,Viper,Brimstone,KAY/O,Fade","Raze,Viper,Brimstone,Skye,Chamber",1588
72443,32350,"VALORANT Champions Tour 2022 - Stage 2 - Masters Copenhagen - Group Stage","Split",6426,"OpTic Gaming",386,"Guild Esports",1,14,16,4,8,1,0,1,5,10,9,6,1,0,1,6,9,10,5,"standard","2022-07-10T00:00:00.000Z","[3211,398,2483,2716,2841]","[449,966,1834,2318,2321]","Raze,Astra,KAY/O,Chamber,Fade","Breach,Raze,Cypher,Sage,Omen",1588
72442,32350,"VALORANT Champions Tour 2022 - Stage 2 - Masters Copenhagen - Group Stage","Icebox",6426,"OpTic Gaming",386,"Guild Esports",2,11,13,4,8,0,0,0,7,5,4,8,2,1,1,8,4,5,7,"standard","2022-07-10T00:00:00.000Z","[2841,398,3211,2716,2483]","[449,2321,2318,966,1834]","Viper,Brimstone,KAY/O,Chamber,Fade","Sova,Viper,Sage,KAY/O,Chamber",1588
72441,32349,"VALORANT Champions Tour 2022 - Stage 2 - Masters Copenhagen - Group Stage","Icebox",6344,"LOUD",976,"KRÜ Esports",2,10,13,7,5,1,0,1,3,8,7,5,1,0,1,5,7,8,3,"standard","2022-07-10T00:00:00.000Z","[4746,6037,2895,4748,2294]","[3535,4712,4710,1725,2532]","Viper,Sage,KAY/O,Chamber,Fade","Sova,Viper,Sage,KAY/O,Chamber",1588
72440,32349,"VALORANT Champions Tour 2022 - Stage 2 - Masters Copenhagen - Group Stage","Haven",6344,"LOUD",976,"KRÜ Esports",2,9,13,5,7,0,0,0,4,6,5,7,2,1,1,7,5,6,4,"standard","2022-07-10T00:00:00.000Z","[2895,4748,6037,4746,2294]","[4712,1725,3535,2532,4710]","Breach,Raze,Omen,Chamber,Fade","Breach,Raze,Omen,Chamber,Fade",1588
72439,32349,"VALORANT Champions Tour 2022 - Stage 2 - Masters Copenhagen - Group Stage","Fracture",6344,"LOUD",976,"KRÜ Esports",1,13,10,8,4,0,0,0,8,4,5,6,2,1,1,6,5,4,8,"standard","2022-07-10T00:00:00.000Z","[2294,4748,6037,2895,4746]","[4712,1725,3535,4710,2532]","Breach,Raze,Brimstone,Sage,Chamber","Breach,Raze,Brimstone,Sage,Chamber",1588
72446,32351,"VALORANT Champions Tour 2022 - Stage 2 - Masters Copenhagen - Group Stage","Bind",286,"DRX",1840,"NORTHEPTION",1,13,1,11,1,2,1,1,11,1,2,0,0,0,0,0,2,1,11,"standard","2022-07-10T00:00:00.000Z","[1550,452,814,582,1251]","[3060,2272,652,12341,8882]","Raze,Viper,Brimstone,Skye,Chamber","Breach,Brimstone,Chamber,Neon,Fade",1588
72445,32351,"VALORANT Champions Tour 2022 - Stage 2 - Masters Copenhagen - Group Stage","Ascent",286,"DRX",1840,"NORTHEPTION",1,13,8,8,4,2,1,1,8,4,5,4,0,0,0,4,5,4,8,"standard","2022-07-10T00:00:00.000Z","[1251,452,1550,582,814]","[2272,12341,8882,652,3060]","Killjoy,Omen,Jett,KAY/O,Fade","Killjoy,Jett,Astra,KAY/O,Fade",1588
71394,31921,"VCT North America 2022 - Stage 2 Challengers - Playoffs","Ascent",6426,"OpTic Gaming",603,"XSET",2,11,13,9,3,2,1,1,2,10,9,3,0,0,0,3,9,10,2,"standard","2022-06-26T00:00:00.000Z","[2483,398,3211,2716,2841]","[3582,3062,3346,1802,494]","Sova,Astra,KAY/O,Chamber,Fade","Sova,Killjoy,Omen,Jett,KAY/O",1588
71381,31917,"VCT LATAM 2022 - Stage 2 - Playoffs","Split",976,"KRÜ Esports",738,"Leviatán",2,3,13,0,12,1,1,0,3,1,0,12,1,1,0,12,0,1,3,"standard","2022-06-26T00:00:00.000Z","[1725,4712,4710,3535,2532]","[3531,3421,21588,3532,6414]","Raze,Viper,Skye,Astra,Chamber","Breach,Astra,KAY/O,Chamber,Neon",1588
71393,31921,"VCT North America 2022 - Stage 2 Challengers - Playoffs","Bind",6426,"OpTic Gaming",603,"XSET",1,7,13,3,9,1,0,1,3,9,4,4,1,0,1,4,4,9,3,"standard","2022-06-26T00:00:00.000Z","[2841,2483,398,2716,3211]","[3582,3062,494,3346,1802]","Breach,Skye,Astra,Chamber,Neon","Raze,Viper,Brimstone,Skye,Chamber",1588
71392,31921,"VCT North America 2022 - Stage 2 Challengers - Playoffs","Haven",6426,"OpTic Gaming",603,"XSET",2,3,13,3,9,0,0,0,0,4,3,9,2,1,1,9,3,4,0,"standard","2022-06-26T00:00:00.000Z","[2483,398,2841,2716,3211]","[494,3062,3582,3346,1802]","Skye,Astra,KAY/O,Chamber,Neon","Breach,Omen,Jett,Skye,Chamber",1588
71380,31917,"VCT LATAM 2022 - Stage 2 - Playoffs","Ascent",976,"KRÜ Esports",738,"Leviatán",1,5,13,3,9,2,1,1,3,9,2,4,0,0,0,4,2,9,3,"standard","2022-06-26T00:00:00.000Z","[1725,4712,3535,2532,4710]","[3531,3421,6414,3532,21588]","Raze,Sova,Omen,Chamber,Fade","Sova,Astra,KAY/O,Chamber,Fade",1588
71391,31921,"VCT North America 2022 - Stage 2 Challengers - Playoffs","Fracture",6426,"OpTic Gaming",603,"XSET",1,14,12,5,7,1,0,1,6,7,8,5,1,0,1,5,8,7,6,"standard","2022-06-26T00:00:00.000Z","[2841,398,2483,2716,3211]","[494,3062,3346,1802,3582]","Breach,Brimstone,KAY/O,Chamber,Neon","Breach,Brimstone,Sage,Chamber,Neon",1588
71379,31917,"VCT LATAM 2022 - Stage 2 - Playoffs","Haven",976,"KRÜ Esports",738,"Leviatán",2,10,13,7,5,2,1,1,3,8,7,5,0,0,0,5,7,8,3,"standard","2022-06-26T00:00:00.000Z","[4712,1725,3535,2532,4710]","[3531,6414,3421,3532,21588]","Breach,Raze,Omen,Chamber,Fade","Breach,Raze,Omen,Chamber,Fade",1588
71567,32016,"VCT Brazil 2022 - Stage 2 Challengers - Playoffs","Icebox",6344,"LOUD",5750,"Ninjas in Pyjamas",1,13,6,7,5,1,0,1,7,5,6,1,1,0,1,1,6,5,7,"standard","2022-06-26T00:00:00.000Z","[4746,6037,2895,4748,2294]","[3203,2901,762,16804,2195]","Viper,Sage,KAY/O,Chamber,Fade","Killjoy,Viper,Omen,KAY/O,Neon",1588
71566,32016,"VCT Brazil 2022 - Stage 2 Challengers - Playoffs","Fracture",6344,"LOUD",5750,"Ninjas in Pyjamas",1,13,10,7,5,1,1,0,7,5,6,5,1,1,0,5,6,5,7,"standard","2022-06-26T00:00:00.000Z","[2294,4748,6037,2895,4746]","[762,2901,16804,3203,2195]","Breach,Raze,Brimstone,Sage,Chamber","Breach,Brimstone,KAY/O,Chamber,Neon",1588
71565,32016,"VCT Brazil 2022 - Stage 2 Challengers - Playoffs","Bind",6344,"LOUD",5750,"Ninjas in Pyjamas",1,13,8,7,5,1,0,1,7,5,6,3,1,0,1,3,6,5,7,"standard","2022-06-26T00:00:00.000Z","[4748,4746,6037,2895,2294]","[762,2901,3203,2195,16804]","Raze,Viper,Brimstone,Skye,Fade","Breach,Brimstone,Chamber,Neon,Fade",1588
71366,31914,"VCT EMEA 2022 - Stage 2 Challengers - Playoffs","Haven",1625,"FNATIC",17,"FunPlus Phoenix",1,15,13,8,4,1,1,0,9,5,6,8,1,1,0,8,6,5,9,"standard","2022-06-26T00:00:00.000Z","[76,14543,718,2011,2937]","[3043,2225,2335,2359,1256]","Breach,Raze,Sova,Omen,Chamber","Sova,Killjoy,Omen,Jett,KAY/O",1588
71365,31914,"VCT EMEA 2022 - Stage 2 Challengers - Playoffs","Icebox",1625,"FNATIC",17,"FunPlus Phoenix",1,13,5,10,2,1,0,1,10,2,3,3,1,0,1,3,3,2,10,"standard","2022-06-26T00:00:00.000Z","[718,14543,2011,76,2937]","[1256,2335,2225,2359,3043]","Sova,Killjoy,Viper,Sage,Chamber","Sova,Killjoy,Viper,Sage,Chamber",1588
71364,31914,"VCT EMEA 2022 - Stage 2 Challengers - Playoffs","Split",1625,"FNATIC",17,"FunPlus Phoenix",2,15,13,7,5,1,1,0,6,8,9,5,1,1,0,5,9,8,6,"standard","2022-06-26T00:00:00.000Z","[14543,76,2011,2937,718]","[1256,2225,2335,2359,3043]","Raze,Viper,Omen,Chamber,Fade","Raze,Cypher,Viper,Astra,KAY/O",1588
71649,32046,"VCT Korea 2022 - Stage 2 Challengers - Playoffs","Ascent",286,"DRX",6366,"Maru Gaming",1,13,3,9,3,2,1,1,9,3,4,0,0,0,0,0,4,3,9,"standard","2022-06-26T00:00:00.000Z","[1251,452,1550,582,814]","[4229,8382,2762,6719,6595]","Killjoy,Omen,Jett,KAY/O,Fade","Omen,Jett,Astra,KAY/O,Fade",1588
71735,32076,"VCT 2022: APAC Stage 2 Challengers - Playoffs","Breeze",184,"Paper Rex",5903,"XERXIA Esports",1,13,5,10,2,2,1,1,10,2,3,3,0,0,0,3,3,2,10,"standard","2022-06-26T00:00:00.000Z","[8387,8385,8386,8388,432]","[766,671,6890,3642,21245]","Sova,Viper,Jett,Skye,Chamber","Viper,Jett,Skye,KAY/O,Chamber",1588
71648,32046,"VCT Korea 2022 - Stage 2 Challengers - Playoffs","Haven",286,"DRX",6366,"Maru Gaming",1,13,9,8,4,1,0,1,8,4,5,5,1,0,1,5,5,4,8,"standard","2022-06-26T00:00:00.000Z","[582,814,1251,452,1550]","[6595,4229,2762,8382,6719]","Breach,Sova,Killjoy,Omen,Jett","Breach,Raze,Omen,Jett,Chamber",1588
71734,32076,"VCT 2022: APAC Stage 2 Challengers - Playoffs","Fracture",184,"Paper Rex",5903,"XERXIA Esports",2,13,4,8,4,2,1,1,5,0,8,4,0,0,0,4,8,0,5,"standard","2022-06-26T00:00:00.000Z","[8387,432,8385,8388,8386]","[3642,671,766,21245,6890]","Breach,Raze,Viper,Chamber,Neon","Breach,Cypher,Brimstone,Jett,Fade",1588
71647,32046,"VCT Korea 2022 - Stage 2 Challengers - Playoffs","Split",286,"DRX",6366,"Maru Gaming",1,13,4,9,3,2,1,1,9,3,4,1,0,0,0,1,4,3,9,"standard","2022-06-26T00:00:00.000Z","[582,452,1251,1550,814]","[6595,4229,2762,6719,8382]","Breach,Omen,Chamber,Neon,Fade","Breach,Sage,Omen,Chamber,Neon",1588
71733,32076,"VCT 2022: APAC Stage 2 Challengers - Playoffs","Icebox",184,"Paper Rex",5903,"XERXIA Esports",1,13,8,8,4,0,0,0,8,4,5,4,2,1,1,4,5,4,8,"standard","2022-06-26T00:00:00.000Z","[8385,432,8386,8388,8387]","[6890,671,766,3642,21245]","Viper,Sage,Jett,Chamber,Fade","Sova,Killjoy,Viper,Sage,Jett",1588
71645,32045,"VCT Japan 2022 - Stage 2 Challengers - Main Event","Ascent",611,"ZETA DIVISION",1840,"NORTHEPTION",2,7,13,5,7,0,0,0,2,6,5,7,2,1,1,7,5,6,2,"standard","2022-06-26T00:00:00.000Z","[519,2232,1593,2212,2699]","[2272,8882,652,12341,3060]","Raze,Astra,KAY/O,Chamber,Fade","Killjoy,Astra,KAY/O,Chamber,Fade",1588
71644,32045,"VCT Japan 2022 - Stage 2 Challengers - Main Event","Fracture",611,"ZETA DIVISION",1840,"NORTHEPTION",2,4,13,2,10,1,0,1,2,3,2,10,1,0,1,10,2,3,2,"standard","2022-06-26T00:00:00.000Z","[2699,519,1593,2232,2212]","[3060,652,8882,12341,2272]","Breach,Raze,Viper,Astra,Chamber","Breach,Raze,Brimstone,Chamber,Neon",1588
71641,32044,"VCT 2022: APAC Stage 2 Challengers - Playoffs","Icebox",4696,"Team Secret",5903,"XERXIA Esports",2,8,13,4,8,0,0,0,4,5,4,8,2,1,1,8,4,5,4,"standard","2022-06-26T00:00:00.000Z","[405,2674,3076,193,9537]","[6890,671,766,3642,21245]","Sova,Killjoy,Viper,Jett,Chamber","Sova,Killjoy,Viper,Sage,Jett",1588
71643,32045,"VCT Japan 2022 - Stage 2 Challengers - Main Event","Haven",611,"ZETA DIVISION",1840,"NORTHEPTION",1,13,4,8,4,1,0,1,8,4,5,0,1,0,1,0,5,4,8,"standard","2022-06-26T00:00:00.000Z","[2232,519,2212,1593,2699]","[3060,2272,12341,652,8882]","Astra,KAY/O,Chamber,Neon,Fade","Breach,Killjoy,Jett,Skye,Astra",1588
71640,32044,"VCT 2022: APAC Stage 2 Challengers - Playoffs","Ascent",4696,"Team Secret",5903,"XERXIA Esports",1,10,13,5,7,0,0,0,5,7,5,6,2,1,1,6,5,7,5,"standard","2022-06-26T00:00:00.000Z","[405,193,3076,2121,9537]","[671,21245,766,3642,6890]","Sova,Jett,Astra,KAY/O,Chamber","Killjoy,Jett,Astra,KAY/O,Fade",1588
71642,32045,"VCT Japan 2022 - Stage 2 Challengers - Main Event","Icebox",611,"ZETA DIVISION",1840,"NORTHEPTION",2,11,13,7,5,1,1,0,4,8,7,5,1,1,0,5,7,8,4,"standard","2022-06-26T00:00:00.000Z","[2699,2232,519,2212,1593]","[2272,8882,12341,3060,652]","Sova,Viper,Sage,Chamber,Fade","Sova,Viper,Jett,KAY/O,Chamber",1588
71639,32044,"VCT 2022: APAC Stage 2 Challengers - Playoffs","Haven",4696,"Team Secret",5903,"XERXIA Esports",1,13,3,9,3,2,1,1,9,3,4,0,0,0,0,0,4,3,9,"standard","2022-06-26T00:00:00.000Z","[9537,405,2674,3076,193]","[3642,6890,671,21245,766]","Breach,Sova,Killjoy,Omen,Jett","Breach,Sova,Killjoy,Jett,Astra",1588
71399,31922,"VCT North America 2022 - Stage 2 Challengers - Playoffs","Ascent",603,"XSET",617,"FaZe Clan",2,13,4,9,3,2,1,1,4,1,9,3,0,0,0,3,9,1,4,"standard","2022-06-26T00:00:00.000Z","[3582,3062,3346,1802,494]","[1689,1994,369,789,1990]","Sova,Killjoy,Omen,Jett,KAY/O","Sova,Astra,KAY/O,Chamber,Fade",1588
71712,31916,"VCT LATAM 2022 - Stage 2 - Playoffs","Ascent",6025,"FUSION",738,"Leviatán",2,10,13,3,9,1,1,0,7,4,3,9,1,1,0,9,3,4,7,"standard","2022-06-25T00:00:00.000Z","[2471,5350,3578,3265,321]","[3531,3421,6414,3532,21588]","Raze,Omen,KAY/O,Chamber,Fade","Sova,Astra,KAY/O,Chamber,Fade",1588
71711,31916,"VCT LATAM 2022 - Stage 2 - Playoffs","Breeze",6025,"FUSION",738,"Leviatán",1,14,12,7,5,1,1,0,8,5,6,7,1,1,0,7,6,5,8,"standard","2022-06-25T00:00:00.000Z","[321,5350,3265,3578,2471]","[3531,3421,21588,6414,3532]","Sova,Viper,Jett,KAY/O,Chamber","Sova,Viper,Skye,KAY/O,Chamber",1588
71398,31922,"VCT North America 2022 - Stage 2 Challengers - Playoffs","Icebox",603,"XSET",617,"FaZe Clan",1,16,14,9,3,0,0,0,11,4,5,10,2,1,1,10,5,4,11,"standard","2022-06-25T00:00:00.000Z","[3346,3062,3582,494,1802]","[1689,1994,789,1990,369]","Sova,Viper,Sage,KAY/O,Chamber","Sova,Viper,Sage,KAY/O,Chamber",1588
71378,31916,"VCT LATAM 2022 - Stage 2 - Playoffs","Split",6025,"FUSION",738,"Leviatán",2,6,13,5,7,1,0,1,1,6,5,7,1,0,1,7,5,6,1,"standard","2022-06-25T00:00:00.000Z","[2471,321,3578,5350,3265]","[3531,3421,21588,3532,6414]","Raze,Viper,Skye,Astra,Chamber","Breach,Astra,KAY/O,Chamber,Neon",1588
71397,31922,"VCT North America 2022 - Stage 2 Challengers - Playoffs","Breeze",603,"XSET",617,"FaZe Clan",2,13,10,6,6,1,1,0,7,4,6,6,1,1,0,6,6,4,7,"standard","2022-06-25T00:00:00.000Z","[494,3346,3062,1802,3582]","[1689,1994,1990,789,369]","Cypher,Sova,Viper,Jett,KAY/O","Sova,Viper,KAY/O,Chamber,Neon",1588
71377,31916,"VCT LATAM 2022 - Stage 2 - Playoffs","Icebox",6025,"FUSION",738,"Leviatán",1,1,13,1,11,0,0,0,1,11,0,2,2,1,1,2,0,11,1,"standard","2022-06-25T00:00:00.000Z","[3578,3265,5350,321,2471]","[3531,6414,3421,21588,3532]","Sova,Killjoy,Viper,Sage,Chamber","Sova,Viper,Sage,KAY/O,Chamber",1588
71346,31908,"VCT Brazil 2022 - Stage 2 Challengers - Playoffs","Split",5750,"Ninjas in Pyjamas",600,"Keyd Stars",1,13,6,9,3,2,1,1,9,3,4,3,0,0,0,3,4,3,9,"standard","2022-06-25T00:00:00.000Z","[3203,762,16804,2901,2195]","[957,81,277,4771,5288]","Raze,Cypher,Sage,Omen,Jett","Breach,Raze,Sage,Omen,Chamber",1588
71396,31922,"VCT North America 2022 - Stage 2 Challengers - Playoffs","Split",603,"XSET",617,"FaZe Clan",2,11,13,7,5,1,0,1,4,8,7,5,1,0,1,5,7,8,4,"standard","2022-06-25T00:00:00.000Z","[3582,3062,3346,494,1802]","[1689,1994,1990,789,369]","Raze,Viper,Skye,Astra,Chamber","Breach,Astra,KAY/O,Chamber,Neon",1588
71376,31916,"VCT LATAM 2022 - Stage 2 - Playoffs","Bind",6025,"FUSION",738,"Leviatán",2,13,11,9,3,1,1,0,4,8,9,3,1,1,0,3,9,8,4,"standard","2022-06-25T00:00:00.000Z","[2471,5350,3578,3265,321]","[6414,3531,3421,21588,3532]","Raze,Brimstone,Skye,Chamber,Fade","Raze,Viper,Brimstone,Skye,Chamber",1588
71345,31908,"VCT Brazil 2022 - Stage 2 Challengers - Playoffs","Haven",5750,"Ninjas in Pyjamas",600,"Keyd Stars",2,13,11,6,6,1,0,1,7,5,6,6,1,0,1,6,6,5,7,"standard","2022-06-25T00:00:00.000Z","[2901,16804,762,3203,2195]","[957,81,4771,277,5288]","Omen,Skye,KAY/O,Chamber,Neon","Breach,Raze,Omen,Skye,Chamber",1588
71344,31908,"VCT Brazil 2022 - Stage 2 Challengers - Playoffs","Icebox",5750,"Ninjas in Pyjamas",600,"Keyd Stars",1,13,10,6,6,1,0,1,6,6,7,4,1,0,1,4,7,6,6,"standard","2022-06-25T00:00:00.000Z","[3203,2901,762,16804,2195]","[81,957,4771,277,5288]","Killjoy,Viper,Omen,KAY/O,Neon","Raze,Sova,Viper,Sage,Chamber",1588
71343,31908,"VCT Brazil 2022 - Stage 2 Challengers - Playoffs","Breeze",5750,"Ninjas in Pyjamas",600,"Keyd Stars",1,11,13,4,8,2,1,1,4,8,7,5,0,0,0,5,7,8,4,"standard","2022-06-25T00:00:00.000Z","[762,16804,2901,2195,3203]","[957,4771,5288,81,277]","Cypher,Sova,Viper,Jett,KAY/O","Sova,Viper,Jett,Skye,Chamber",1588
71342,31908,"VCT Brazil 2022 - Stage 2 Challengers - Playoffs","Ascent",5750,"Ninjas in Pyjamas",600,"Keyd Stars",2,13,15,7,5,1,0,1,5,9,8,6,1,0,1,6,8,9,5,"standard","2022-06-25T00:00:00.000Z","[16804,762,2901,3203,2195]","[957,81,4771,5288,277]","Sova,Killjoy,Omen,Jett,Fade","Breach,Raze,Omen,Chamber,Fade",1588
71371,31915,"VCT EMEA 2022 - Stage 2 Challengers - Playoffs","Split",386,"Guild Esports",17,"FunPlus Phoenix",2,4,13,4,8,0,0,0,0,5,4,8,2,1,1,8,4,5,0,"standard","2022-06-25T00:00:00.000Z","[966,2318,2321,1834,449]","[1256,2225,2335,2359,3043]","Raze,Viper,Omen,Chamber,Fade","Raze,Killjoy,Viper,Astra,KAY/O",1588
71370,31915,"VCT EMEA 2022 - Stage 2 Challengers - Playoffs","Haven",386,"Guild Esports",17,"FunPlus Phoenix",1,11,13,7,5,2,1,1,7,5,4,8,0,0,0,8,4,5,7,"standard","2022-06-25T00:00:00.000Z","[2318,966,449,2321,1834]","[1256,2225,2335,3043,2359]","Breach,Raze,Sova,Omen,Chamber","Raze,Sage,Omen,Chamber,Fade",1588
71369,31915,"VCT EMEA 2022 - Stage 2 Challengers - Playoffs","Fracture",386,"Guild Esports",17,"FunPlus Phoenix",1,4,13,2,10,1,0,1,2,10,2,3,1,0,1,3,2,10,2,"standard","2022-06-25T00:00:00.000Z","[449,966,2318,2321,1834]","[1256,2225,2335,3043,2359]","Breach,Raze,Viper,Astra,Chamber","Raze,Viper,Omen,Chamber,Fade",1588
71542,32002,"VCT 2022: APAC Stage 2 Challengers - Playoffs","Icebox",667,"Onic Esports",5903,"XERXIA Esports",2,5,13,1,11,1,1,0,4,2,1,11,1,1,0,11,1,2,4,"standard","2022-06-25T00:00:00.000Z","[9970,3583,3496,3377,3380]","[6890,671,766,3642,21245]","Sova,Viper,Sage,Jett,KAY/O","Sova,Killjoy,Viper,Sage,Jett",1588
71541,32002,"VCT 2022: APAC Stage 2 Challengers - Playoffs","Breeze",667,"Onic Esports",5903,"XERXIA Esports",2,8,13,4,8,2,1,1,4,5,4,8,0,0,0,8,4,5,4,"standard","2022-06-25T00:00:00.000Z","[9970,3380,3377,3496,3583]","[6890,766,671,3642,21245]","Sova,Viper,Jett,KAY/O,Chamber","Sova,Viper,Jett,Skye,Chamber",1588
71389,31920,"VCT 2022: APAC Stage 2 Challengers - Playoffs","Bind",184,"Paper Rex",4696,"Team Secret",1,13,2,10,2,1,0,1,10,2,3,0,1,0,1,0,3,2,10,"standard","2022-06-25T00:00:00.000Z","[8387,432,8385,8386,8388]","[2121,405,2674,3076,193]","Breach,Raze,Brimstone,Yoru,Fade","Raze,Sova,Killjoy,Brimstone,Yoru",1588
71519,31958,"VCT Korea 2022 - Stage 2 Challengers - Playoffs","Breeze",997,"DAMWON Gaming",6366,"Maru Gaming",1,14,16,5,7,1,1,0,6,9,8,7,1,1,0,7,8,9,6,"standard","2022-06-25T00:00:00.000Z","[2368,315,4811,2240,6546]","[6595,2762,8382,4229,6719]","Sova,Viper,Jett,Astra,KAY/O","Sova,Viper,Jett,KAY/O,Chamber",1588
71388,31920,"VCT 2022: APAC Stage 2 Challengers - Playoffs","Ascent",184,"Paper Rex",4696,"Team Secret",1,13,7,7,5,2,1,1,7,5,6,2,0,0,0,2,6,5,7,"standard","2022-06-25T00:00:00.000Z","[432,8385,8388,8386,8387]","[405,3076,9537,2674,193]","Raze,Astra,KAY/O,Chamber,Fade","Sova,Omen,Jett,KAY/O,Chamber",1588
71448,31958,"VCT Korea 2022 - Stage 2 Challengers - Playoffs","Split",997,"DAMWON Gaming",6366,"Maru Gaming",1,3,13,3,9,0,0,0,3,9,0,4,2,1,1,4,0,9,3,"standard","2022-06-25T00:00:00.000Z","[315,2368,2240,4811,6546]","[6595,4229,2762,6719,8382]","Breach,Sage,Omen,Jett,Chamber","Breach,Sage,Omen,Chamber,Neon",1588
71447,31958,"VCT Korea 2022 - Stage 2 Challengers - Playoffs","Haven",997,"DAMWON Gaming",6366,"Maru Gaming",1,13,6,9,3,2,1,1,9,3,4,3,0,0,0,3,4,3,9,"standard","2022-06-25T00:00:00.000Z","[315,2368,2240,6546,4811]","[6595,4229,2762,8382,6719]","Breach,Sova,Omen,Chamber,Neon","Breach,Raze,Omen,Jett,Chamber",1588
71387,31919,"VCT 2022: APAC Stage 2 Challengers - Playoffs","Icebox",4838,"Bleed Esports",5903,"XERXIA Esports",1,12,14,6,6,2,1,1,6,7,6,7,0,0,0,7,6,7,6,"standard","2022-06-25T00:00:00.000Z","[6625,645,7877,2639,6639]","[6890,671,766,3642,21245]","Sova,Killjoy,Viper,Sage,Jett","Sova,Killjoy,Viper,Sage,Jett",1588
71427,31940,"VCT Japan 2022 - Stage 2 Challengers - Main Event","Haven",444,"Crazy Raccoon",1840,"NORTHEPTION",2,9,13,5,7,1,0,1,4,6,5,7,1,0,1,7,5,6,4,"standard","2022-06-25T00:00:00.000Z","[8025,1231,2388,815,1886]","[3060,2272,12341,652,8882]","Breach,Sova,Killjoy,Omen,Jett","Breach,Killjoy,Jett,Skye,Astra",1588
71386,31919,"VCT 2022: APAC Stage 2 Challengers - Playoffs","Fracture",4838,"Bleed Esports",5903,"XERXIA Esports",1,5,13,3,9,2,1,1,3,9,2,4,0,0,0,4,2,9,3,"standard","2022-06-25T00:00:00.000Z","[6625,6639,7877,645,2639]","[3642,671,766,21245,6890]","Breach,Raze,Viper,Chamber,Neon","Breach,Cypher,Brimstone,Jett,Fade",1588
71446,31958,"VCT Korea 2022 - Stage 2 Challengers - Playoffs","Ascent",997,"DAMWON Gaming",6366,"Maru Gaming",1,9,13,7,5,1,1,0,7,5,2,8,1,1,0,8,2,5,7,"standard","2022-06-25T00:00:00.000Z","[315,2240,4811,6546,2368]","[4229,8382,2762,6719,6595]","Sage,Omen,Jett,KAY/O,Fade","Omen,Jett,Astra,KAY/O,Fade",1588
71426,31940,"VCT Japan 2022 - Stage 2 Challengers - Main Event","Breeze",444,"Crazy Raccoon",1840,"NORTHEPTION",2,6,13,3,9,1,1,0,3,4,3,9,1,1,0,9,3,4,3,"standard","2022-06-25T00:00:00.000Z","[815,1231,8025,1886,2388]","[2272,8882,12341,3060,652]","Cypher,Sova,Viper,Jett,KAY/O","Sova,Viper,Jett,Skye,Chamber",1588
71385,31919,"VCT 2022: APAC Stage 2 Challengers - Playoffs","Haven",4838,"Bleed Esports",5903,"XERXIA Esports",2,13,11,4,8,1,1,0,9,3,4,8,1,1,0,8,4,3,9,"standard","2022-06-25T00:00:00.000Z","[645,6625,2639,7877,6639]","[3642,6890,671,21245,766]","Breach,Sova,Killjoy,Omen,Jett","Breach,Sova,Killjoy,Jett,Astra",1588
71384,31918,"VCT 2022: APAC Stage 2 Challengers - Playoffs","Ascent",667,"Onic Esports",493,"Alter Ego",2,13,6,8,4,2,1,1,5,2,8,4,0,0,0,4,8,2,5,"standard","2022-06-25T00:00:00.000Z","[3377,3496,3380,3583,9970]","[3358,25260,25261,9957,956]","Jett,Astra,KAY/O,Chamber,Fade","Sova,Sage,Omen,Jett,KAY/O",1588
71383,31918,"VCT 2022: APAC Stage 2 Challengers - Playoffs","Fracture",667,"Onic Esports",493,"Alter Ego",2,4,13,2,10,1,1,0,2,3,2,10,1,1,0,10,2,3,2,"standard","2022-06-25T00:00:00.000Z","[9970,3496,3380,3583,3377]","[956,25261,3358,25260,9957]","Breach,Brimstone,KAY/O,Chamber,Neon","Breach,Brimstone,KAY/O,Chamber,Neon",1588
69868,31236,"VCT Japan 2022 - Stage 2 Challengers - Main Event","Ascent",1840,"NORTHEPTION",611,"ZETA DIVISION",1,9,13,7,5,0,0,0,7,5,2,8,2,1,1,8,2,5,7,"standard","2022-06-25T00:00:00.000Z","[2272,8882,652,12341,3060]","[519,2232,1593,2212,2699]","Killjoy,Astra,KAY/O,Chamber,Fade","Raze,Astra,KAY/O,Chamber,Fade",1588
71382,31918,"VCT 2022: APAC Stage 2 Challengers - Playoffs","Haven",667,"Onic Esports",493,"Alter Ego",1,13,8,5,7,1,0,1,5,7,8,1,1,0,1,1,8,7,5,"standard","2022-06-25T00:00:00.000Z","[3583,3380,3496,9970,3377]","[3358,956,25261,25260,9957]","Sova,Omen,KAY/O,Chamber,Neon","Cypher,Reyna,Omen,Skye,Neon",1588
70727,31635,"VCT North America 2022 - Stage 2 Challengers - Playoffs","Ascent",116,"NRG Esports",617,"FaZe Clan",2,8,13,2,10,1,1,0,6,3,2,10,1,1,0,10,2,3,6,"standard","2022-06-25T00:00:00.000Z","[165,1232,10253,1763,1597]","[1689,1994,369,789,1990]","Sage,Omen,KAY/O,Chamber,Fade","Sova,Astra,KAY/O,Chamber,Fade",1588
69867,31236,"VCT Japan 2022 - Stage 2 Challengers - Main Event","Fracture",1840,"NORTHEPTION",611,"ZETA DIVISION",2,7,13,3,9,2,1,1,4,4,3,9,0,0,0,9,3,4,4,"standard","2022-06-25T00:00:00.000Z","[3060,652,8882,12341,2272]","[2699,519,1593,2232,2212]","Breach,Raze,Brimstone,Chamber,Neon","Breach,Raze,Viper,Astra,Chamber",1588
70726,31635,"VCT North America 2022 - Stage 2 Challengers - Playoffs","Haven",116,"NRG Esports",617,"FaZe Clan",2,13,8,8,4,2,1,1,5,4,8,4,0,0,0,4,8,4,5,"standard","2022-06-25T00:00:00.000Z","[10253,165,1597,1232,1763]","[1689,1994,1990,789,369]","Breach,Raze,Sova,Astra,Chamber","Breach,Omen,Skye,Chamber,Neon",1588
70725,31635,"VCT North America 2022 - Stage 2 Challengers - Playoffs","Icebox",116,"NRG Esports",617,"FaZe Clan",1,11,13,2,10,2,1,1,2,10,9,3,0,0,0,3,9,10,2,"standard","2022-06-25T00:00:00.000Z","[1597,1232,10253,165,1763]","[1689,1994,789,1990,369]","Sova,Viper,Sage,Omen,Chamber","Sova,Viper,Sage,KAY/O,Chamber",1588
70723,31634,"VCT North America 2022 - Stage 2 Challengers - Playoffs","Breeze",603,"XSET",6426,"OpTic Gaming",1,6,13,4,8,1,1,0,4,8,2,5,1,1,0,5,2,8,4,"standard","2022-06-24T00:00:00.000Z","[494,3346,3062,1802,3582]","[2483,2841,3211,398,2716]","Cypher,Sova,Viper,Jett,KAY/O","Sova,Viper,Jett,KAY/O,Chamber",1588
71261,31880,"VCT LATAM 2022 - Stage 2 - Playoffs","Icebox",6025,"FUSION",976,"KRÜ Esports",1,10,13,7,5,1,1,0,7,5,3,8,1,1,0,8,3,5,7,"standard","2022-06-24T00:00:00.000Z","[3578,3265,5350,321,2471]","[3535,4712,4710,1725,2532]","Sova,Killjoy,Viper,Sage,Chamber","Sova,Viper,Sage,KAY/O,Chamber",1588
70722,31634,"VCT North America 2022 - Stage 2 Challengers - Playoffs","Ascent",603,"XSET",6426,"OpTic Gaming",2,11,13,9,3,1,0,1,2,10,9,3,1,0,1,3,9,10,2,"standard","2022-06-24T00:00:00.000Z","[3582,3062,3346,1802,494]","[2483,398,3211,2716,2841]","Sova,Killjoy,Omen,Jett,KAY/O","Sova,Astra,KAY/O,Chamber,Fade",1588
71260,31880,"VCT LATAM 2022 - Stage 2 - Playoffs","Breeze",6025,"FUSION",976,"KRÜ Esports",2,7,13,7,5,0,0,0,0,8,7,5,2,1,1,5,7,8,0,"standard","2022-06-24T00:00:00.000Z","[3578,5350,321,3265,2471]","[4712,3535,1725,4710,2532]","Sova,Viper,Reyna,Jett,Chamber","Sova,Viper,Jett,KAY/O,Chamber",1588
70721,31634,"VCT North America 2022 - Stage 2 Challengers - Playoffs","Icebox",603,"XSET",6426,"OpTic Gaming",1,11,13,7,5,1,1,0,7,5,4,8,1,1,0,8,4,5,7,"standard","2022-06-24T00:00:00.000Z","[3346,3062,3582,494,1802]","[2841,398,3211,2716,2483]","Sova,Viper,Sage,KAY/O,Chamber","Viper,Brimstone,KAY/O,Chamber,Fade",1588
70720,31634,"VCT North America 2022 - Stage 2 Challengers - Playoffs","Haven",603,"XSET",6426,"OpTic Gaming",2,13,7,5,7,1,1,0,8,0,5,7,1,1,0,7,5,0,8,"standard","2022-06-24T00:00:00.000Z","[494,3062,3582,3346,1802]","[2483,398,2841,2716,3211]","Breach,Omen,Jett,Skye,Chamber","Skye,Astra,KAY/O,Chamber,Neon",1588
71264,31881,"VCT LATAM 2022 - Stage 2 - Playoffs","Icebox",738,"Leviatán",553,"E-Xolos LAZER",2,13,9,8,4,0,0,0,5,5,8,4,2,1,1,4,8,5,5,"standard","2022-06-24T00:00:00.000Z","[3531,6414,3421,21588,3532]","[14639,3274,3252,1141,2773]","Sova,Viper,Sage,KAY/O,Chamber","Sova,Killjoy,Viper,KAY/O,Chamber",1588
71263,31881,"VCT LATAM 2022 - Stage 2 - Playoffs","Bind",738,"Leviatán",553,"E-Xolos LAZER",1,13,9,4,8,2,1,1,4,8,9,1,0,0,0,1,9,8,4,"standard","2022-06-24T00:00:00.000Z","[6414,3531,3421,21588,3532]","[2773,1141,3252,3274,14639]","Raze,Viper,Brimstone,Skye,Chamber","Raze,Omen,Skye,Chamber,Fade",1588
70742,31640,"VCT EMEA 2022 - Stage 2 Challengers - Playoffs","Fracture",17,"FunPlus Phoenix",6656,"M3 Champions",2,13,4,10,2,2,1,1,3,2,10,2,0,0,0,2,10,2,3,"standard","2022-06-24T00:00:00.000Z","[1256,2225,2335,3043,2359]","[2528,274,1964,3135,1081]","Raze,Viper,Omen,Chamber,Fade","Breach,Raze,Omen,KAY/O,Chamber",1588
71122,31826,"VCT Brazil 2022 - Stage 2 Challengers - Playoffs","Breeze",6344,"LOUD",5750,"Ninjas in Pyjamas",2,13,6,9,3,2,1,1,4,3,9,3,0,0,0,3,9,3,4,"standard","2022-06-24T00:00:00.000Z","[2294,6037,4748,2895,4746]","[762,16804,2901,2195,3203]","Sova,Viper,Jett,KAY/O,Chamber","Cypher,Sova,Viper,Jett,KAY/O",1588
70741,31640,"VCT EMEA 2022 - Stage 2 Challengers - Playoffs","Breeze",17,"FunPlus Phoenix",6656,"M3 Champions",1,9,13,7,5,1,1,0,7,5,2,8,1,1,0,8,2,5,7,"standard","2022-06-24T00:00:00.000Z","[2359,2225,2335,1256,3043]","[2528,1081,1964,3135,274]","Sova,Viper,Yoru,KAY/O,Chamber","Sova,Viper,Omen,KAY/O,Chamber",1588
71121,31826,"VCT Brazil 2022 - Stage 2 Challengers - Playoffs","Haven",6344,"LOUD",5750,"Ninjas in Pyjamas",2,13,5,8,4,2,1,1,5,1,8,4,0,0,0,4,8,1,5,"standard","2022-06-24T00:00:00.000Z","[2895,4748,6037,4746,2294]","[2901,16804,762,3203,2195]","Breach,Raze,Omen,Chamber,Fade","Omen,Skye,KAY/O,Chamber,Neon",1588
70740,31640,"VCT EMEA 2022 - Stage 2 Challengers - Playoffs","Ascent",17,"FunPlus Phoenix",6656,"M3 Champions",1,13,11,7,5,2,1,1,7,5,6,6,0,0,0,6,6,5,7,"standard","2022-06-24T00:00:00.000Z","[2225,2335,1256,3043,2359]","[274,1964,2528,1081,3135]","Sage,Omen,KAY/O,Chamber,Fade","Raze,Omen,KAY/O,Chamber,Fade",1588
71120,31826,"VCT Brazil 2022 - Stage 2 Challengers - Playoffs","Icebox",6344,"LOUD",5750,"Ninjas in Pyjamas",1,13,4,9,3,1,0,1,9,3,4,1,1,0,1,1,4,3,9,"standard","2022-06-24T00:00:00.000Z","[4746,6037,2895,4748,2294]","[3203,2901,762,16804,2195]","Viper,Sage,KAY/O,Chamber,Fade","Killjoy,Viper,Omen,KAY/O,Neon",1588
70613,31594,"VCT EMEA 2022 - Stage 2 Challengers - Playoffs","Haven",386,"Guild Esports",1625,"FNATIC",1,11,13,4,8,1,0,1,4,8,7,5,1,0,1,5,7,8,4,"standard","2022-06-24T00:00:00.000Z","[2318,966,2321,1834,449]","[76,14543,718,2011,2937]","Breach,Raze,Omen,Chamber,Fade","Breach,Raze,Sova,Omen,Chamber",1588
70612,31594,"VCT EMEA 2022 - Stage 2 Challengers - Playoffs","Bind",386,"Guild Esports",1625,"FNATIC",1,9,13,6,6,0,0,0,6,6,3,7,2,1,1,7,3,6,6,"standard","2022-06-24T00:00:00.000Z","[966,2321,2318,1834,449]","[2937,14543,76,2011,718]","Raze,Brimstone,Skye,Chamber,Fade","Raze,Viper,Skye,Astra,Fade",1588
71219,31863,"VCT 2022: APAC Stage 2 Challengers - Playoffs","Ascent",15,"BOOM Esports",5903,"XERXIA Esports",1,1,13,1,11,0,0,0,1,11,0,2,2,1,1,2,0,11,1,"standard","2022-06-24T00:00:00.000Z","[3361,3363,3365,1919,217]","[671,21245,766,3642,6890]","Sova,Jett,Astra,KAY/O,Chamber","Killjoy,Jett,Astra,KAY/O,Fade",1588
71218,31863,"VCT 2022: APAC Stage 2 Challengers - Playoffs","Bind",15,"BOOM Esports",5903,"XERXIA Esports",1,7,13,2,10,0,0,0,2,10,5,3,2,1,1,3,5,10,2,"standard","2022-06-24T00:00:00.000Z","[3363,3365,3361,1919,217]","[671,766,3642,6890,21245]","Raze,Viper,Brimstone,Skye,Chamber","Raze,Viper,Brimstone,Skye,Chamber",1588
71217,31863,"VCT 2022: APAC Stage 2 Challengers - Playoffs","Icebox",15,"BOOM Esports",5903,"XERXIA Esports",2,13,2,10,2,2,1,1,3,0,10,2,0,0,0,2,10,0,3,"standard","2022-06-24T00:00:00.000Z","[1919,217,3365,3361,3363]","[6890,671,766,3642,21245]","Sova,Killjoy,Viper,Sage,Chamber","Sova,Killjoy,Viper,Sage,Jett",1588
71215,31862,"VCT 2022: APAC Stage 2 Challengers - Playoffs","Split",493,"Alter Ego",1643,"Griffin E-Sports",2,13,3,9,3,2,1,1,4,0,9,3,0,0,0,3,9,0,4,"standard","2022-06-24T00:00:00.000Z","[9957,3358,25261,956,25260]","[707,796,1309,2170,3419]","Raze,Cypher,Omen,Skye,Fade","Breach,Cypher,Sage,Jett,Astra",1588
71214,31862,"VCT 2022: APAC Stage 2 Challengers - Playoffs","Bind",493,"Alter Ego",1643,"Griffin E-Sports",1,13,11,7,5,1,0,1,7,5,6,6,1,0,1,6,6,5,7,"standard","2022-06-24T00:00:00.000Z","[9957,25261,956,25260,3358]","[796,707,3419,1309,2170]","Raze,Brimstone,Skye,Chamber,Fade","Breach,Raze,Brimstone,Sage,Skye",1588
71212,31861,"VCT 2022: APAC Stage 2 Challengers - Playoffs","Breeze",667,"Onic Esports",4696,"Team Secret",2,8,13,4,8,0,0,0,4,5,4,8,2,1,1,8,4,5,4,"standard","2022-06-24T00:00:00.000Z","[9970,3380,3377,3496,3583]","[405,3076,193,9537,2121]","Sova,Viper,Jett,KAY/O,Chamber","Sova,Viper,Jett,Skye,Chamber",1588
71211,31861,"VCT 2022: APAC Stage 2 Challengers - Playoffs","Icebox",667,"Onic Esports",4696,"Team Secret",1,8,13,4,8,2,1,1,4,8,4,5,0,0,0,5,4,8,4,"standard","2022-06-24T00:00:00.000Z","[9970,3583,3496,3377,3380]","[405,2674,3076,193,9537]","Sova,Viper,Sage,Jett,KAY/O","Sova,Killjoy,Viper,Jett,Chamber",1588
71210,31860,"VCT 2022: APAC Stage 2 Challengers - Playoffs","Ascent",184,"Paper Rex",4838,"Bleed Esports",1,13,9,10,2,1,1,0,10,2,3,7,1,1,0,7,3,2,10,"standard","2022-06-24T00:00:00.000Z","[432,8385,8388,8386,8387]","[2639,6625,645,7877,6639]","Raze,Astra,KAY/O,Chamber,Fade","Breach,Sova,Killjoy,Omen,Jett",1588
71209,31860,"VCT 2022: APAC Stage 2 Challengers - Playoffs","Fracture",184,"Paper Rex",4838,"Bleed Esports",2,13,4,8,4,2,1,1,5,0,8,4,0,0,0,4,8,0,5,"standard","2022-06-24T00:00:00.000Z","[8387,432,8385,8388,8386]","[6625,2639,7877,6639,645]","Breach,Raze,Viper,Chamber,Neon","Breach,Raze,Brimstone,Jett,Chamber",1588
71208,31860,"VCT 2022: APAC Stage 2 Challengers - Playoffs","Split",184,"Paper Rex",4838,"Bleed Esports",2,7,13,2,10,1,1,0,5,3,2,10,1,1,0,10,2,3,5,"standard","2022-06-24T00:00:00.000Z","[432,8387,8385,8386,8388]","[6639,645,2639,6625,7877]","Raze,Cypher,Omen,Chamber,Fade","Raze,Viper,Sage,Skye,Astra",1588
71237,31872,"VCT Brazil 2022 - Stage 2 Challengers - Playoffs","Icebox",600,"Keyd Stars",5748,"Los Grandes",2,13,5,9,3,1,1,0,4,2,9,3,1,1,0,3,9,2,4,"standard","2022-06-23T00:00:00.000Z","[81,957,4771,277,5288]","[4770,6231,2103,669,2420]","Raze,Sova,Viper,Sage,Chamber","Sova,Viper,Sage,Chamber,Fade",1588
70366,31487,"VCT LATAM 2022 - Stage 2 - Playoffs","Icebox",976,"KRÜ Esports",553,"E-Xolos LAZER",2,13,10,6,6,2,1,1,7,4,6,6,0,0,0,6,6,4,7,"standard","2022-06-23T00:00:00.000Z","[3535,4712,4710,1725,2532]","[14639,3274,3252,1141,2773]","Sova,Viper,Sage,KAY/O,Chamber","Sova,Killjoy,Viper,KAY/O,Chamber",1588
71236,31872,"VCT Brazil 2022 - Stage 2 Challengers - Playoffs","Bind",600,"Keyd Stars",5748,"Los Grandes",2,13,7,6,6,2,1,1,7,1,6,6,0,0,0,6,6,1,7,"standard","2022-06-23T00:00:00.000Z","[81,277,4771,957,5288]","[6231,4770,2420,2103,669]","Raze,Viper,Brimstone,Skye,Chamber","Breach,Raze,Sova,Brimstone,Skye",1588
70365,31487,"VCT LATAM 2022 - Stage 2 - Playoffs","Bind",976,"KRÜ Esports",553,"E-Xolos LAZER",1,13,5,9,3,2,1,1,9,3,4,2,0,0,0,2,4,3,9,"standard","2022-06-23T00:00:00.000Z","[1725,4712,3535,4710,2532]","[2773,1141,3252,3274,14639]","Raze,Viper,Brimstone,Skye,Chamber","Raze,Omen,Skye,Chamber,Fade",1588
71082,31798,"VCT Brazil 2022 - Stage 2 Challengers - Playoffs","Ascent",5748,"Los Grandes",1264,"FURIA",1,13,9,7,5,2,1,1,7,5,6,4,0,0,0,4,6,5,7,"standard","2022-06-23T00:00:00.000Z","[6231,2103,4770,669,2420]","[2749,6039,18192,2423,2752]","Breach,Omen,Yoru,Chamber,Fade","Omen,Jett,KAY/O,Chamber,Fade",1588
70364,31486,"VCT LATAM 2022 - Stage 2 - Playoffs","Ascent",6025,"FUSION",738,"Leviatán",1,13,11,8,4,2,1,1,8,4,5,7,0,0,0,7,5,4,8,"standard","2022-06-23T00:00:00.000Z","[2471,5350,3578,3265,321]","[3531,3421,6414,3532,21588]","Raze,Omen,KAY/O,Chamber,Fade","Sova,Astra,KAY/O,Chamber,Fade",1588
71081,31798,"VCT Brazil 2022 - Stage 2 Challengers - Playoffs","Haven",5748,"Los Grandes",1264,"FURIA",2,13,11,5,7,1,0,1,8,4,5,7,1,0,1,7,5,4,8,"standard","2022-06-23T00:00:00.000Z","[6231,4770,2103,669,2420]","[18192,2752,2749,6039,2423]","Breach,Raze,Astra,Chamber,Fade","Breach,Killjoy,Omen,Skye,Neon",1588
70363,31486,"VCT LATAM 2022 - Stage 2 - Playoffs","Bind",6025,"FUSION",738,"Leviatán",1,5,13,5,7,0,0,0,5,7,0,6,2,1,1,6,0,7,5,"standard","2022-06-23T00:00:00.000Z","[2471,5350,3578,3265,321]","[6414,3531,3421,21588,3532]","Raze,Brimstone,Skye,Chamber,Fade","Raze,Viper,Brimstone,Skye,Chamber",1588
71080,31798,"VCT Brazil 2022 - Stage 2 Challengers - Playoffs","Icebox",5748,"Los Grandes",1264,"FURIA",2,10,13,4,8,1,1,0,6,5,4,8,1,1,0,8,4,5,6,"standard","2022-06-23T00:00:00.000Z","[4770,6231,2103,669,2420]","[18192,2749,6039,2752,2423]","Sova,Viper,Sage,Chamber,Fade","Sova,Killjoy,Viper,Sage,Chamber",1588
70362,31486,"VCT LATAM 2022 - Stage 2 - Playoffs","Breeze",6025,"FUSION",738,"Leviatán",1,13,7,7,5,1,0,1,7,5,6,2,1,0,1,2,6,5,7,"standard","2022-06-23T00:00:00.000Z","[3578,5350,321,3265,2471]","[3531,3421,21588,6414,3532]","Sova,Viper,Reyna,Jett,Chamber","Sova,Viper,Skye,KAY/O,Chamber",1588
71068,31787,"VCT Brazil 2022 - Stage 2 Challengers - Playoffs","Fracture",600,"Keyd Stars",5675,"MIBR",1,13,10,5,7,1,0,1,5,7,8,3,1,0,1,3,8,7,5,"standard","2022-06-23T00:00:00.000Z","[957,81,4771,277,5288]","[211,4577,3105,1877,11296]","Breach,Raze,Brimstone,Sage,Chamber","Breach,Brimstone,Sage,Chamber,Neon",1588
71067,31787,"VCT Brazil 2022 - Stage 2 Challengers - Playoffs","Breeze",600,"Keyd Stars",5675,"MIBR",2,20,18,9,3,0,0,0,8,11,12,7,2,1,1,7,12,11,8,"standard","2022-06-23T00:00:00.000Z","[957,4771,5288,81,277]","[211,4577,11296,3105,1877]","Sova,Viper,Jett,Skye,Chamber","Sova,Viper,Jett,KAY/O,Chamber",1588
70719,31633,"VCT 2022: APAC Stage 2 Challengers - Playoffs","Ascent",5903,"XERXIA Esports",4696,"Team Secret",1,9,13,7,5,2,1,1,7,5,2,8,0,0,0,8,2,5,7,"standard","2022-06-23T00:00:00.000Z","[6890,766,3642,21245,671]","[405,3076,9537,2674,193]","Sova,Astra,KAY/O,Chamber,Fade","Sova,Omen,Jett,KAY/O,Chamber",1588
70718,31633,"VCT 2022: APAC Stage 2 Challengers - Playoffs","Breeze",5903,"XERXIA Esports",4696,"Team Secret",1,4,13,2,10,0,0,0,2,10,2,3,2,1,1,3,2,10,2,"standard","2022-06-23T00:00:00.000Z","[671,766,6890,3642,21245]","[405,3076,193,9537,2121]","Sova,Viper,Skye,KAY/O,Chamber","Sova,Viper,Jett,Skye,Chamber",1588
70717,31633,"VCT 2022: APAC Stage 2 Challengers - Playoffs","Haven",5903,"XERXIA Esports",4696,"Team Secret",1,13,6,11,1,1,1,0,11,1,2,5,1,1,0,5,2,1,11,"standard","2022-06-23T00:00:00.000Z","[3642,6890,671,21245,766]","[405,2674,9537,3076,193]","Breach,Sova,Killjoy,Jett,Astra","Sova,Killjoy,Jett,Astra,KAY/O",1588
70716,31632,"VCT 2022: APAC Stage 2 Challengers - Playoffs","Icebox",667,"Onic Esports",15,"BOOM Esports",2,13,6,8,4,1,0,1,5,2,8,4,1,0,1,4,8,2,5,"standard","2022-06-23T00:00:00.000Z","[9970,3583,3496,3377,3380]","[1919,217,3365,3361,3363]","Sova,Viper,Sage,Jett,KAY/O","Sova,Killjoy,Viper,Sage,Chamber",1588
70715,31632,"VCT 2022: APAC Stage 2 Challengers - Playoffs","Split",667,"Onic Esports",15,"BOOM Esports",2,9,13,6,6,1,0,1,3,7,6,6,1,0,1,6,6,7,3,"standard","2022-06-23T00:00:00.000Z","[9970,3377,3583,3496,3380]","[3361,3365,1919,217,3363]","Breach,Raze,Cypher,Omen,Skye","Breach,Astra,KAY/O,Chamber,Neon",1588
70714,31632,"VCT 2022: APAC Stage 2 Challengers - Playoffs","Ascent",667,"Onic Esports",15,"BOOM Esports",1,13,9,6,6,2,1,1,6,6,7,3,0,0,0,3,7,6,6,"standard","2022-06-23T00:00:00.000Z","[9970,3377,3496,3380,3583]","[3361,3363,3365,1919,217]","Sova,Jett,Astra,KAY/O,Chamber","Sova,Jett,Astra,KAY/O,Chamber",1588
70712,31631,"VCT 2022: APAC Stage 2 Challengers - Playoffs","Breeze",4838,"Bleed Esports",1643,"Griffin E-Sports",1,13,7,6,6,2,1,1,6,6,7,1,0,0,0,1,7,6,6,"standard","2022-06-23T00:00:00.000Z","[645,6625,7877,6639,2639]","[1309,3419,2170,707,796]","Cypher,Sova,Viper,Jett,Skye","Sova,Viper,Jett,KAY/O,Chamber",1588
70711,31631,"VCT 2022: APAC Stage 2 Challengers - Playoffs","Ascent",4838,"Bleed Esports",1643,"Griffin E-Sports",1,13,9,8,4,1,1,0,8,4,5,5,1,1,0,5,5,4,8,"standard","2022-06-23T00:00:00.000Z","[2639,6625,645,7877,6639]","[707,796,2170,3419,1309]","Breach,Sova,Killjoy,Omen,Jett","Sova,Killjoy,Jett,Astra,KAY/O",1588
70710,31630,"VCT 2022: APAC Stage 2 Challengers - Playoffs","Icebox",184,"Paper Rex",493,"Alter Ego",1,13,7,6,6,1,0,1,6,6,7,1,1,0,1,1,7,6,6,"standard","2022-06-23T00:00:00.000Z","[8385,432,8386,8388,8387]","[3358,25261,9957,956,25260]","Viper,Sage,Jett,Chamber,Fade","Sova,Viper,Jett,KAY/O,Chamber",1588
70709,31630,"VCT 2022: APAC Stage 2 Challengers - Playoffs","Fracture",184,"Paper Rex",493,"Alter Ego",1,12,14,6,6,1,1,0,6,7,6,7,1,1,0,7,6,7,6,"standard","2022-06-23T00:00:00.000Z","[8387,432,8385,8388,8386]","[956,25261,3358,25260,9957]","Breach,Raze,Viper,Chamber,Neon","Breach,Brimstone,KAY/O,Chamber,Neon",1588
70708,31630,"VCT 2022: APAC Stage 2 Challengers - Playoffs","Bind",184,"Paper Rex",493,"Alter Ego",1,13,10,8,4,1,1,0,8,4,5,6,1,1,0,6,5,4,8,"standard","2022-06-23T00:00:00.000Z","[432,8387,8385,8386,8388]","[9957,25261,956,25260,3358]","Raze,Viper,Brimstone,Chamber,Fade","Raze,Brimstone,Skye,Chamber,Fade",1588
70738,31639,"VCT Brazil 2022 - Stage 2 Challengers - Playoffs","Ascent",5750,"Ninjas in Pyjamas",600,"Keyd Stars",1,13,5,9,3,1,1,0,9,3,4,2,1,1,0,2,4,3,9,"standard","2022-06-22T00:00:00.000Z","[16804,762,2901,3203,2195]","[957,81,4771,5288,277]","Sova,Killjoy,Omen,Jett,Fade","Breach,Raze,Omen,Chamber,Fade",1588
70737,31639,"VCT Brazil 2022 - Stage 2 Challengers - Playoffs","Icebox",5750,"Ninjas in Pyjamas",600,"Keyd Stars",2,13,4,9,3,2,1,1,4,1,9,3,0,0,0,3,9,1,4,"standard","2022-06-22T00:00:00.000Z","[3203,2901,762,16804,2195]","[81,277,4771,957,5288]","Killjoy,Viper,Omen,KAY/O,Neon","Sova,Killjoy,Viper,Sage,Chamber",1588
70735,31638,"VCT Brazil 2022 - Stage 2 Challengers - Playoffs","Split",6344,"LOUD",5748,"Los Grandes",2,13,9,6,6,1,1,0,7,3,6,6,1,1,0,6,6,3,7,"standard","2022-06-22T00:00:00.000Z","[2895,4748,4746,6037,2294]","[6231,4770,2103,2420,669]","Breach,Raze,Viper,Astra,Fade","Breach,Raze,Astra,KAY/O,Chamber",1588
70734,31638,"VCT Brazil 2022 - Stage 2 Challengers - Playoffs","Breeze",6344,"LOUD",5748,"Los Grandes",1,13,3,10,2,1,0,1,10,2,3,1,1,0,1,1,3,2,10,"standard","2022-06-22T00:00:00.000Z","[2294,6037,4748,2895,4746]","[4770,2103,6231,2420,669]","Sova,Viper,Jett,KAY/O,Chamber","Raze,Sova,Viper,KAY/O,Chamber",1588
70733,31637,"VCT Brazil 2022 - Stage 2 Challengers - Playoffs","Split",1264,"FURIA",600,"Keyd Stars",2,7,13,6,6,1,0,1,1,7,6,6,1,0,1,6,6,7,1,"standard","2022-06-21T00:00:00.000Z","[6039,18192,2749,2752,2423]","[957,81,277,4771,5288]","Raze,Sage,Omen,Skye,Chamber","Breach,Raze,Sage,Omen,Chamber",1588
70732,31637,"VCT Brazil 2022 - Stage 2 Challengers - Playoffs","Icebox",1264,"FURIA",600,"Keyd Stars",2,13,10,8,4,1,0,1,5,6,8,4,1,0,1,4,8,6,5,"standard","2022-06-21T00:00:00.000Z","[18192,2749,6039,2752,2423]","[81,4771,957,277,5288]","Sova,Killjoy,Viper,Sage,Chamber","Sova,Viper,Sage,KAY/O,Chamber",1588
70731,31637,"VCT Brazil 2022 - Stage 2 Challengers - Playoffs","Breeze",1264,"FURIA",600,"Keyd Stars",2,10,13,7,5,1,0,1,3,8,7,5,1,0,1,5,7,8,3,"standard","2022-06-21T00:00:00.000Z","[18192,2749,6039,2752,2423]","[957,4771,5288,81,277]","Sova,Viper,Jett,KAY/O,Chamber","Sova,Viper,Jett,Skye,Chamber",1588
70730,31636,"VCT Brazil 2022 - Stage 2 Challengers - Playoffs","Icebox",5675,"MIBR",5748,"Los Grandes",1,10,13,5,7,0,0,0,5,7,5,6,2,1,1,6,5,7,5,"standard","2022-06-21T00:00:00.000Z","[211,1877,4577,3105,11296]","[4770,6231,2103,669,2420]","Sova,Viper,Sage,KAY/O,Chamber","Sova,Viper,Sage,Chamber,Fade",1588
70729,31636,"VCT Brazil 2022 - Stage 2 Challengers - Playoffs","Fracture",5675,"MIBR",5748,"Los Grandes",2,13,9,6,6,1,1,0,7,3,6,6,1,1,0,6,6,3,7,"standard","2022-06-21T00:00:00.000Z","[211,4577,3105,1877,11296]","[6231,4770,2103,2420,669]","Breach,Brimstone,Sage,Chamber,Neon","Breach,Raze,Brimstone,KAY/O,Chamber",1588
70728,31636,"VCT Brazil 2022 - Stage 2 Challengers - Playoffs","Haven",5675,"MIBR",5748,"Los Grandes",1,8,13,3,9,1,0,1,3,9,5,4,1,0,1,4,5,9,3,"standard","2022-06-21T00:00:00.000Z","[3105,11296,4577,1877,211]","[6231,4770,2103,669,2420]","Breach,Raze,Omen,Chamber,Fade","Breach,Raze,Astra,Chamber,Fade",1588
70850,31713,"VCT Korea 2022 - Stage 2 Challengers - Playoffs","Bind",6366,"Maru Gaming",1515,"World Game Star",2,13,7,7,5,1,0,1,6,2,7,5,1,0,1,5,7,2,6,"standard","2022-06-21T00:00:00.000Z","[6595,4229,2762,6719,8382]","[2687,3522,293,23167,2650]","Breach,Raze,Brimstone,Chamber,Neon","Breach,Omen,Skye,Chamber,Neon",1588
70849,31713,"VCT Korea 2022 - Stage 2 Challengers - Playoffs","Breeze",6366,"Maru Gaming",1515,"World Game Star",1,13,7,6,6,2,1,1,6,6,7,1,0,0,0,1,7,6,6,"standard","2022-06-21T00:00:00.000Z","[6595,2762,8382,4229,6719]","[293,3522,2687,23167,2650]","Sova,Viper,Jett,KAY/O,Chamber","Sova,Viper,Jett,KAY/O,Chamber",1588
70847,31712,"VCT Korea 2022 - Stage 2 Challengers - Playoffs","Split",286,"DRX",997,"DAMWON Gaming",1,13,10,8,4,2,1,1,8,4,5,6,0,0,0,6,5,4,8,"standard","2022-06-21T00:00:00.000Z","[582,452,1251,1550,814]","[315,2368,2240,4811,6546]","Breach,Omen,Chamber,Neon,Fade","Breach,Sage,Omen,Jett,Chamber",1588
70846,31712,"VCT Korea 2022 - Stage 2 Challengers - Playoffs","Fracture",286,"DRX",997,"DAMWON Gaming",2,13,8,6,6,2,1,1,7,2,6,6,0,0,0,6,6,2,7,"standard","2022-06-21T00:00:00.000Z","[452,582,1251,1550,814]","[315,2368,2240,6546,4811]","Brimstone,KAY/O,Chamber,Neon,Fade","Breach,Cypher,Astra,Chamber,Neon",1588
70674,31614,"VCT Korea 2022 - Stage 2 Challengers - Playoffs","Haven",1515,"World Game Star",1267,"Spear Gaming",1,13,6,8,4,2,1,1,8,4,5,2,0,0,0,2,5,4,8,"standard","2022-06-20T00:00:00.000Z","[23167,293,2687,3522,2650]","[8076,18840,6600,18839,15737]","Breach,Sova,Jett,Astra,Chamber","Breach,Sova,Killjoy,Omen,Jett",1588
70673,31614,"VCT Korea 2022 - Stage 2 Challengers - Playoffs","Bind",1515,"World Game Star",1267,"Spear Gaming",1,10,13,6,6,1,0,1,6,6,4,7,1,0,1,7,4,6,6,"standard","2022-06-20T00:00:00.000Z","[2687,3522,293,23167,2650]","[15737,8076,18839,6600,18840]","Breach,Omen,Skye,Chamber,Neon","Raze,Viper,Brimstone,Chamber,Fade",1588
70672,31614,"VCT Korea 2022 - Stage 2 Challengers - Playoffs","Split",1515,"World Game Star",1267,"Spear Gaming",2,14,12,6,6,1,1,0,7,6,7,6,1,1,0,6,7,6,7,"standard","2022-06-20T00:00:00.000Z","[23167,293,2687,3522,2650]","[15737,8076,18840,18839,6600]","Breach,Sage,Jett,Astra,Chamber","Raze,Viper,Sage,Omen,Skye",1588
70667,31612,"VCT 2022: APAC Stage 2 Challengers - Group Stage","Ascent",3457,"Fancy United Esports",4696,"Team Secret",1,7,13,4,8,2,1,1,4,8,3,5,0,0,0,5,3,8,4,"standard","2022-06-20T00:00:00.000Z","[13767,2556,13645,1836,3691]","[405,3076,9537,2674,193]","Breach,Omen,Astra,KAY/O,Chamber","Sova,Omen,Jett,KAY/O,Chamber",1588
70666,31612,"VCT 2022: APAC Stage 2 Challengers - Group Stage","Haven",3457,"Fancy United Esports",4696,"Team Secret",1,6,13,3,9,1,0,1,3,9,3,4,1,0,1,4,3,9,3,"standard","2022-06-20T00:00:00.000Z","[13767,2556,1836,13645,3691]","[405,2674,9537,3076,193]","Breach,Omen,Skye,Astra,Chamber","Sova,Killjoy,Jett,Astra,KAY/O",1588
70670,31613,"VCT Korea 2022 - Stage 2 Challengers - Playoffs","Fracture",5373,"On Sla2ers",6366,"Maru Gaming",1,3,13,3,9,0,0,0,3,9,0,4,2,1,1,4,0,9,3,"standard","2022-06-20T00:00:00.000Z","[1199,2904,2009,2151,1075]","[6595,2762,6719,4229,8382]","Breach,Raze,Brimstone,Sage,Chamber","Breach,Brimstone,KAY/O,Chamber,Neon",1588
70665,31611,"VCT 2022: APAC Stage 2 Challengers - Group Stage","Fracture",101,"ORDER",15,"BOOM Esports",2,4,13,3,9,0,0,0,1,4,3,9,2,1,1,9,3,4,1,"standard","2022-06-20T00:00:00.000Z","[40,1046,824,2691,2271]","[3365,3361,1919,217,3363]","Breach,Brimstone,KAY/O,Chamber,Neon","Breach,Brimstone,KAY/O,Chamber,Neon",1588
70669,31613,"VCT Korea 2022 - Stage 2 Challengers - Playoffs","Bind",5373,"On Sla2ers",6366,"Maru Gaming",1,11,13,5,7,0,0,0,5,7,6,6,2,1,1,6,6,7,5,"standard","2022-06-20T00:00:00.000Z","[2904,2151,2009,1075,1199]","[6595,4229,2762,6719,8382]","Raze,Viper,Brimstone,Skye,Fade","Breach,Raze,Brimstone,Chamber,Neon",1588
70664,31611,"VCT 2022: APAC Stage 2 Challengers - Group Stage","Split",101,"ORDER",15,"BOOM Esports",2,13,1,11,1,2,1,1,2,0,11,1,0,0,0,1,11,0,2,"standard","2022-06-20T00:00:00.000Z","[824,2691,2271,40,1046]","[3361,3365,1919,217,3363]","Breach,Raze,Cypher,Skye,Astra","Breach,Astra,KAY/O,Chamber,Neon",1588
70663,31611,"VCT 2022: APAC Stage 2 Challengers - Group Stage","Haven",101,"ORDER",15,"BOOM Esports",1,9,13,6,6,0,0,0,6,6,3,7,2,1,1,7,3,6,6,"standard","2022-06-20T00:00:00.000Z","[824,1046,2691,40,2271]","[3365,3361,1919,217,3363]","Breach,Omen,Jett,Skye,Chamber","Breach,Omen,Skye,Chamber,Neon",1588
70662,31610,"VCT 2022: APAC Stage 2 Challengers - Group Stage","Icebox",493,"Alter Ego",516,"Rex Regum Qeon",2,13,5,9,3,2,1,1,4,2,9,3,0,0,0,3,9,2,4,"standard","2022-06-20T00:00:00.000Z","[3358,25261,9957,956,25260]","[24,9124,3042,2794,2097]","Sova,Viper,Jett,KAY/O,Chamber","Sova,Viper,Jett,KAY/O,Chamber",1588
70661,31610,"VCT 2022: APAC Stage 2 Challengers - Group Stage","Split",493,"Alter Ego",516,"Rex Regum Qeon",2,11,13,7,5,0,0,0,4,8,7,5,2,1,1,5,7,8,4,"standard","2022-06-20T00:00:00.000Z","[9957,3358,25261,956,25260]","[3042,2097,24,2794,9124]","Raze,Cypher,Omen,KAY/O,Fade","Raze,Cypher,Sage,Omen,Skye",1588
70660,31610,"VCT 2022: APAC Stage 2 Challengers - Group Stage","Bind",493,"Alter Ego",516,"Rex Regum Qeon",1,13,4,8,4,2,1,1,8,4,5,0,0,0,0,0,5,4,8,"standard","2022-06-20T00:00:00.000Z","[9957,25261,956,25260,3358]","[2794,3042,2097,9124,24]","Raze,Brimstone,Skye,Chamber,Fade","Breach,Raze,Cypher,Astra,Fade",1588
70629,31599,"VCT North America 2022 - Stage 2 Challengers - Playoffs","Breeze",305,"100 Thieves",617,"FaZe Clan",2,11,13,5,7,2,1,1,6,6,5,7,0,0,0,7,5,6,6,"standard","2022-06-20T00:00:00.000Z","[122,269,1012,2354,763]","[1689,1994,1990,789,369]","Cypher,Sova,Viper,Jett,KAY/O","Sova,Viper,KAY/O,Chamber,Neon",1588
70628,31599,"VCT North America 2022 - Stage 2 Challengers - Playoffs","Fracture",305,"100 Thieves",617,"FaZe Clan",2,10,13,3,9,1,1,0,7,4,3,9,1,1,0,9,3,4,7,"standard","2022-06-20T00:00:00.000Z","[269,763,1012,122,2354]","[1689,1994,1990,789,369]","Breach,Raze,Brimstone,Sage,Chamber","Breach,Brimstone,KAY/O,Chamber,Neon",1588
70627,31599,"VCT North America 2022 - Stage 2 Challengers - Playoffs","Split",305,"100 Thieves",617,"FaZe Clan",1,14,12,4,8,0,0,0,5,8,9,4,2,1,1,4,9,8,5,"standard","2022-06-19T00:00:00.000Z","[269,2354,122,1012,763]","[1689,1994,1990,789,369]","Breach,Raze,Viper,Astra,Fade","Breach,Astra,KAY/O,Chamber,Neon",1588
70626,31598,"VCT North America 2022 - Stage 2 Challengers - Playoffs","Split",1448,"Evil Geniuses",116,"NRG Esports",2,11,13,6,6,2,1,1,5,7,6,6,0,0,0,6,6,7,5,"standard","2022-06-19T00:00:00.000Z","[2882,4157,1023,11672,3842]","[165,1232,10253,1763,1597]","Breach,Raze,Cypher,Skye,Astra","Raze,Omen,KAY/O,Chamber,Fade",1588
70625,31598,"VCT North America 2022 - Stage 2 Challengers - Playoffs","Ascent",1448,"Evil Geniuses",116,"NRG Esports",2,8,13,5,7,0,0,0,3,6,5,7,2,1,1,7,5,6,3,"standard","2022-06-19T00:00:00.000Z","[2882,3842,4157,1023,11672]","[165,1232,10253,1763,1597]","Sova,Omen,Jett,Chamber,Fade","Sage,Omen,KAY/O,Chamber,Fade",1588
70624,31598,"VCT North America 2022 - Stage 2 Challengers - Playoffs","Bind",1448,"Evil Geniuses",116,"NRG Esports",1,13,3,9,3,2,1,1,9,3,4,0,0,0,0,0,4,3,9,"standard","2022-06-19T00:00:00.000Z","[4157,3842,11672,1023,2882]","[10253,165,1232,1763,1597]","Raze,Brimstone,Skye,Chamber,Fade","Breach,Raze,Astra,Chamber,Fade",1588
70608,31592,"VCT EMEA 2022 - Stage 2 Challengers - Playoffs","Breeze",17,"FunPlus Phoenix",2597,"Acend",1,13,3,9,3,2,1,1,9,3,4,0,0,0,0,0,4,3,9,"standard","2022-06-19T00:00:00.000Z","[2359,2225,2335,1256,3043]","[1268,2391,732,691,87]","Sova,Viper,Yoru,KAY/O,Chamber","Viper,Skye,Chamber,Neon,Fade",1588
70607,31592,"VCT EMEA 2022 - Stage 2 Challengers - Playoffs","Icebox",17,"FunPlus Phoenix",2597,"Acend",2,13,11,5,7,1,0,1,8,4,5,7,1,0,1,7,5,4,8,"standard","2022-06-19T00:00:00.000Z","[1256,2335,2225,2359,3043]","[87,1268,691,2391,732]","Sova,Killjoy,Viper,Sage,Chamber","Sova,Viper,Sage,KAY/O,Chamber",1588
70606,31592,"VCT EMEA 2022 - Stage 2 Challengers - Playoffs","Haven",17,"FunPlus Phoenix",2597,"Acend",1,3,13,2,10,1,0,1,2,10,1,3,1,0,1,3,1,10,2,"standard","2022-06-19T00:00:00.000Z","[1256,2359,2225,2335,3043]","[2391,691,1268,732,87]","Raze,Sova,Sage,Omen,Chamber","Breach,Raze,Omen,Chamber,Fade",1588
70611,31593,"VCT EMEA 2022 - Stage 2 Challengers - Playoffs","Bind",6656,"M3 Champions",224,"Team Liquid",1,13,6,6,6,2,1,1,6,6,7,0,0,0,0,0,7,6,6,"standard","2022-06-19T00:00:00.000Z","[274,1081,2528,1964,3135]","[2571,1690,10211,17788,2056]","Raze,Viper,Sage,Omen,Skye","Breach,Raze,Omen,Chamber,Fade",1588
70610,31593,"VCT EMEA 2022 - Stage 2 Challengers - Playoffs","Fracture",6656,"M3 Champions",224,"Team Liquid",1,13,7,8,4,2,1,1,8,4,5,3,0,0,0,3,5,4,8,"standard","2022-06-19T00:00:00.000Z","[2528,274,1964,3135,1081]","[2571,1690,10211,2056,17788]","Breach,Raze,Omen,KAY/O,Chamber","Breach,Raze,Skye,Astra,Chamber",1588
70609,31593,"VCT EMEA 2022 - Stage 2 Challengers - Playoffs","Icebox",6656,"M3 Champions",224,"Team Liquid",2,10,13,6,6,2,1,1,4,7,6,6,0,0,0,6,6,7,4,"standard","2022-06-19T00:00:00.000Z","[2528,1081,1964,3135,274]","[1690,17788,2571,10211,2056]","Sova,Viper,Brimstone,KAY/O,Chamber","Raze,Viper,Sage,Chamber,Fade",1588
70620,31596,"VCT Korea 2022 - Stage 2 Challengers - Playoffs","Ascent",5373,"On Sla2ers",997,"DAMWON Gaming",2,3,13,3,9,1,0,1,0,4,3,9,1,0,1,9,3,4,0,"standard","2022-06-19T00:00:00.000Z","[2151,2904,2009,1075,1199]","[315,2240,4811,6546,2368]","Omen,Skye,Astra,Chamber,Fade","Sage,Omen,Jett,KAY/O,Fade",1588
70619,31596,"VCT Korea 2022 - Stage 2 Challengers - Playoffs","Haven",5373,"On Sla2ers",997,"DAMWON Gaming",1,11,13,5,7,0,0,0,5,7,6,6,2,1,1,6,6,7,5,"standard","2022-06-19T00:00:00.000Z","[2904,2151,1075,2009,1199]","[315,2368,4811,2240,6546]","Breach,Killjoy,Jett,Astra,Fade","Breach,Sova,Jett,Astra,Chamber",1588
70618,31596,"VCT Korea 2022 - Stage 2 Challengers - Playoffs","Bind",5373,"On Sla2ers",997,"DAMWON Gaming",2,13,3,9,3,2,1,1,4,0,9,3,0,0,0,3,9,0,4,"standard","2022-06-19T00:00:00.000Z","[2904,2151,2009,1075,1199]","[4811,315,2368,2240,6546]","Raze,Viper,Brimstone,Skye,Fade","Raze,Viper,Skye,Astra,Chamber",1588
70622,31597,"VCT 2022: APAC Stage 2 Challengers - Group Stage","Breeze",7294,"Gaimin Gladiators",1643,"Griffin E-Sports",2,9,13,4,8,0,0,0,5,5,4,8,2,1,1,8,4,5,5,"standard","2022-06-19T00:00:00.000Z","[873,13634,2755,16660,19663]","[1309,3419,2170,707,796]","Cypher,Sova,Viper,Jett,KAY/O","Sova,Viper,Jett,KAY/O,Chamber",1588
70621,31597,"VCT 2022: APAC Stage 2 Challengers - Group Stage","Ascent",7294,"Gaimin Gladiators",1643,"Griffin E-Sports",1,7,13,4,8,2,1,1,4,8,3,5,0,0,0,5,3,8,4,"standard","2022-06-19T00:00:00.000Z","[2755,19663,16660,873,13634]","[707,796,2170,3419,1309]","Omen,Yoru,KAY/O,Chamber,Fade","Sova,Killjoy,Jett,Astra,KAY/O",1588
70616,31595,"VCT Korea 2022 - Stage 2 Challengers - Playoffs","Haven",286,"DRX",1515,"World Game Star",1,13,3,9,3,2,1,1,9,3,4,0,0,0,0,0,4,3,9,"standard","2022-06-19T00:00:00.000Z","[582,814,1251,1550,452]","[23167,293,2687,3522,2650]","Breach,Sova,Killjoy,Jett,Astra","Breach,Sova,Jett,Astra,Chamber",1588
70615,31595,"VCT Korea 2022 - Stage 2 Challengers - Playoffs","Bind",286,"DRX",1515,"World Game Star",1,13,7,8,4,1,1,0,8,4,5,3,1,1,0,3,5,4,8,"standard","2022-06-19T00:00:00.000Z","[1550,452,814,582,1251]","[2687,3522,293,23167,2650]","Raze,Viper,Brimstone,Skye,Chamber","Breach,Omen,Skye,Chamber,Neon",1588
70575,31581,"VCT 2022: APAC Stage 2 Challengers - Group Stage","Haven",4838,"Bleed Esports",3457,"Fancy United Esports",1,13,6,7,5,2,1,1,7,5,6,1,0,0,0,1,6,5,7,"standard","2022-06-19T00:00:00.000Z","[645,6625,2639,7877,6639]","[13767,2556,1836,13645,3691]","Breach,Sova,Killjoy,Omen,Jett","Breach,Omen,Skye,Astra,Chamber",1588
70574,31581,"VCT 2022: APAC Stage 2 Challengers - Group Stage","Icebox",4838,"Bleed Esports",3457,"Fancy United Esports",1,7,13,3,9,1,0,1,3,9,4,4,1,0,1,4,4,9,3,"standard","2022-06-19T00:00:00.000Z","[645,6625,7877,2639,6639]","[13767,1836,2556,13645,3691]","Cypher,Sova,Viper,Sage,Jett","Sova,Viper,Omen,KAY/O,Chamber",1588
70573,31581,"VCT 2022: APAC Stage 2 Challengers - Group Stage","Split",4838,"Bleed Esports",3457,"Fancy United Esports",1,13,8,8,4,1,1,0,8,4,5,4,1,1,0,4,5,4,8,"standard","2022-06-19T00:00:00.000Z","[6639,645,2639,6625,7877]","[13767,1836,13645,2556,3691]","Raze,Viper,Sage,Skye,Astra","Breach,Raze,Viper,Astra,Neon",1588
70571,31580,"VCT 2022: APAC Stage 2 Challengers - Group Stage","Bind",184,"Paper Rex",101,"ORDER",1,13,6,8,4,1,1,0,8,4,5,2,1,1,0,2,5,4,8,"standard","2022-06-19T00:00:00.000Z","[432,8387,8385,8386,8388]","[2691,1046,824,2271,40]","Raze,Viper,Brimstone,Chamber,Fade","Raze,Brimstone,Skye,Chamber,Fade",1588
70570,31580,"VCT 2022: APAC Stage 2 Challengers - Group Stage","Haven",184,"Paper Rex",101,"ORDER",1,13,8,8,4,2,1,1,8,4,5,4,0,0,0,4,5,4,8,"standard","2022-06-19T00:00:00.000Z","[8387,8388,432,8385,8386]","[824,1046,2691,40,2271]","Cypher,Sova,Reyna,Omen,Jett","Breach,Omen,Jett,Skye,Chamber",1588
69979,31285,"VCT North America 2022 - Stage 2 Challengers - Playoffs","Haven",6426,"OpTic Gaming",1448,"Evil Geniuses",1,13,3,9,3,2,1,1,9,3,4,0,0,0,0,0,4,3,9,"standard","2022-06-18T00:00:00.000Z","[2483,398,2841,2716,3211]","[2882,4157,3842,1023,11672]","Skye,Astra,KAY/O,Chamber,Neon","Breach,Raze,Astra,Chamber,Fade",1588
69978,31285,"VCT North America 2022 - Stage 2 Challengers - Playoffs","Breeze",6426,"OpTic Gaming",1448,"Evil Geniuses",2,13,5,10,2,1,0,1,3,3,10,2,1,0,1,2,10,3,3,"standard","2022-06-18T00:00:00.000Z","[2483,2841,3211,398,2716]","[2882,3842,4157,11672,1023]","Sova,Viper,Jett,KAY/O,Chamber","Sova,Viper,Jett,KAY/O,Chamber",1588
69976,31284,"VCT North America 2022 - Stage 2 Challengers - Playoffs","Ascent",603,"XSET",305,"100 Thieves",2,13,4,10,2,1,0,1,3,2,10,2,1,0,1,2,10,2,3,"standard","2022-06-18T00:00:00.000Z","[3582,3062,3346,1802,494]","[269,122,1012,2354,763]","Sova,Killjoy,Omen,Jett,KAY/O","Sova,Killjoy,Omen,Jett,KAY/O",1588
69975,31284,"VCT North America 2022 - Stage 2 Challengers - Playoffs","Icebox",603,"XSET",305,"100 Thieves",1,13,10,6,6,0,0,0,6,6,7,4,2,1,1,4,7,6,6,"standard","2022-06-18T00:00:00.000Z","[3582,3346,3062,494,1802]","[2354,269,122,1012,763]","Raze,Sova,Viper,KAY/O,Chamber","Raze,Sova,Killjoy,Viper,Sage",1588
69998,31291,"VCT EMEA 2022 - Stage 2 Challengers - Playoffs","Fracture",1625,"FNATIC",17,"FunPlus Phoenix",2,13,9,9,3,1,0,1,4,6,9,3,1,0,1,3,9,6,4,"standard","2022-06-18T00:00:00.000Z","[76,14543,718,2011,2937]","[2225,2335,1256,3043,2359]","Breach,Raze,Viper,Astra,Chamber","Sage,Omen,KAY/O,Chamber,Fade",1588
69997,31291,"VCT EMEA 2022 - Stage 2 Challengers - Playoffs","Ascent",1625,"FNATIC",17,"FunPlus Phoenix",2,12,14,6,6,0,0,0,6,7,6,7,2,1,1,7,6,7,6,"standard","2022-06-18T00:00:00.000Z","[14543,2011,76,2937,718]","[2225,2335,1256,3043,2359]","Raze,Omen,KAY/O,Chamber,Fade","Sage,Omen,KAY/O,Chamber,Fade",1588
69996,31291,"VCT EMEA 2022 - Stage 2 Challengers - Playoffs","Icebox",1625,"FNATIC",17,"FunPlus Phoenix",2,13,6,9,3,1,1,0,4,3,9,3,1,1,0,3,9,3,4,"standard","2022-06-18T00:00:00.000Z","[718,14543,2011,76,2937]","[2359,2225,2335,1256,3043]","Sova,Killjoy,Viper,Sage,Chamber","Sova,Viper,Yoru,KAY/O,Chamber",1588
69994,31290,"VCT EMEA 2022 - Stage 2 Challengers - Playoffs","Fracture",386,"Guild Esports",6656,"M3 Champions",2,13,11,7,5,2,1,1,6,6,7,5,0,0,0,5,7,6,6,"standard","2022-06-18T00:00:00.000Z","[449,966,2321,2318,1834]","[2528,274,1964,3135,1081]","Breach,Raze,Brimstone,Sage,Chamber","Breach,Raze,Omen,KAY/O,Chamber",1588
69993,31290,"VCT EMEA 2022 - Stage 2 Challengers - Playoffs","Breeze",386,"Guild Esports",6656,"M3 Champions",2,13,6,9,3,1,0,1,4,3,9,3,1,0,1,3,9,3,4,"standard","2022-06-18T00:00:00.000Z","[966,449,2321,1834,2318]","[1964,1081,3135,2528,274]","Cypher,Sova,Viper,Jett,Skye","Sova,Viper,Jett,Skye,Chamber",1588
70514,31561,"VCT Korea 2022 - Stage 2 Challengers - Playoffs","Bind",997,"DAMWON Gaming",1267,"Spear Gaming",1,13,11,4,8,1,0,1,4,8,9,3,1,0,1,3,9,8,4,"standard","2022-06-18T00:00:00.000Z","[315,4811,2240,2368,6546]","[15737,18839,8076,6600,18840]","Breach,Raze,Brimstone,Skye,Chamber","Raze,Brimstone,KAY/O,Chamber,Fade",1588
70513,31561,"VCT Korea 2022 - Stage 2 Challengers - Playoffs","Breeze",997,"DAMWON Gaming",1267,"Spear Gaming",1,13,11,5,7,2,1,1,5,7,8,4,0,0,0,4,8,7,5,"standard","2022-06-18T00:00:00.000Z","[2368,315,4811,2240,6546]","[18840,8076,15737,18839,6600]","Sova,Viper,Jett,Astra,KAY/O","Sova,Viper,Jett,KAY/O,Chamber",1588
70512,31560,"VCT Korea 2022 - Stage 2 Challengers - Playoffs","Fracture",6366,"Maru Gaming",1515,"World Game Star",1,6,13,3,9,1,0,1,3,9,3,4,1,0,1,4,3,9,3,"standard","2022-06-18T00:00:00.000Z","[6595,4229,2762,6719,8382]","[293,2687,3522,23167,2650]","Breach,Raze,Brimstone,Chamber,Neon","Breach,Viper,Brimstone,Chamber,Neon",1588
70568,31579,"VCT 2022: APAC Stage 2 Challengers - Group Stage","Icebox",5903,"XERXIA Esports",493,"Alter Ego",1,13,5,9,3,1,1,0,9,3,4,2,1,1,0,2,4,3,9,"standard","2022-06-18T00:00:00.000Z","[6890,671,766,3642,21245]","[9957,3358,25261,956,25260]","Sova,Killjoy,Viper,Sage,Jett","Raze,Sova,Viper,KAY/O,Chamber",1588
70511,31560,"VCT Korea 2022 - Stage 2 Challengers - Playoffs","Haven",6366,"Maru Gaming",1515,"World Game Star",1,11,13,7,5,1,1,0,7,5,4,8,1,1,0,8,4,5,7,"standard","2022-06-18T00:00:00.000Z","[6595,4229,2762,8382,6719]","[23167,293,2687,3522,2650]","Breach,Raze,Omen,Jett,Chamber","Breach,Sova,Jett,Astra,Chamber",1588
70567,31579,"VCT 2022: APAC Stage 2 Challengers - Group Stage","Ascent",5903,"XERXIA Esports",493,"Alter Ego",2,16,14,7,5,1,1,0,7,8,9,6,1,1,0,6,9,8,7,"standard","2022-06-18T00:00:00.000Z","[6890,766,3642,21245,671]","[3358,25260,25261,9957,956]","Sova,Astra,KAY/O,Chamber,Fade","Sova,Sage,Omen,Jett,KAY/O",1588
70510,31560,"VCT Korea 2022 - Stage 2 Challengers - Playoffs","Bind",6366,"Maru Gaming",1515,"World Game Star",2,13,7,6,6,0,0,0,7,1,6,6,2,1,1,6,6,1,7,"standard","2022-06-18T00:00:00.000Z","[6595,4229,2762,6719,8382]","[2687,3522,293,23167,2650]","Breach,Raze,Brimstone,Chamber,Neon","Breach,Omen,Skye,Chamber,Neon",1588
70565,31578,"VCT 2022: APAC Stage 2 Challengers - Group Stage","Haven",667,"Onic Esports",7294,"Gaimin Gladiators",2,13,4,10,2,0,0,0,3,2,10,2,2,1,1,2,10,2,3,"standard","2022-06-18T00:00:00.000Z","[3583,3380,3496,9970,3377]","[19663,13634,873,2755,16660]","Sova,Omen,KAY/O,Chamber,Neon","Breach,Sova,Killjoy,Omen,Jett",1588
70564,31578,"VCT 2022: APAC Stage 2 Challengers - Group Stage","Ascent",667,"Onic Esports",7294,"Gaimin Gladiators",1,13,6,10,2,1,1,0,10,2,3,4,1,1,0,4,3,2,10,"standard","2022-06-18T00:00:00.000Z","[3377,3496,3380,3583,9970]","[2755,19663,16660,873,13634]","Jett,Astra,KAY/O,Chamber,Fade","Omen,Yoru,KAY/O,Chamber,Fade",1588
70474,31549,"VCT 2022: APAC Stage 2 Challengers - Group Stage","Icebox",4696,"Team Secret",4232,"FW Esports",2,13,3,11,1,1,0,1,2,2,11,1,1,0,1,1,11,2,2,"standard","2022-06-18T00:00:00.000Z","[405,2674,3076,193,9537]","[16124,13608,21620,13609,13610]","Sova,Killjoy,Viper,Jett,Chamber","Sova,Viper,Sage,Jett,Chamber",1588
70473,31549,"VCT 2022: APAC Stage 2 Challengers - Group Stage","Haven",4696,"Team Secret",4232,"FW Esports",2,13,10,5,7,0,0,0,8,3,5,7,2,1,1,7,5,3,8,"standard","2022-06-18T00:00:00.000Z","[405,2674,9537,3076,193]","[13608,13610,21620,16124,13609]","Sova,Killjoy,Jett,Astra,KAY/O","Breach,Killjoy,Skye,Astra,Neon",1588
69986,31287,"VCT North America 2022 - Stage 2 Challengers - Playoffs","Breeze",617,"FaZe Clan",279,"Luminosity Gaming",1,14,12,5,7,2,1,1,6,7,8,5,0,0,0,5,8,7,6,"standard","2022-06-18T00:00:00.000Z","[1689,1994,1990,789,369]","[3345,2489,1522,905,1801]","Sova,Viper,KAY/O,Chamber,Neon","Cypher,Sova,Viper,Jett,KAY/O",1588
69985,31287,"VCT North America 2022 - Stage 2 Challengers - Playoffs","Fracture",617,"FaZe Clan",279,"Luminosity Gaming",1,13,5,7,5,2,1,1,7,5,6,0,0,0,0,0,6,5,7,"standard","2022-06-17T00:00:00.000Z","[1689,1994,1990,789,369]","[2489,3345,1522,905,1801]","Breach,Brimstone,KAY/O,Chamber,Neon","Breach,Brimstone,KAY/O,Chamber,Neon",1588
69984,31287,"VCT North America 2022 - Stage 2 Challengers - Playoffs","Split",617,"FaZe Clan",279,"Luminosity Gaming",2,9,13,6,6,1,0,1,3,7,6,6,1,0,1,6,6,7,3,"standard","2022-06-17T00:00:00.000Z","[1689,1994,1990,789,369]","[1801,3345,2489,1522,905]","Breach,Astra,KAY/O,Chamber,Neon","Raze,Cypher,Sage,Omen,Jett",1588
69982,31286,"VCT North America 2022 - Stage 2 Challengers - Playoffs","Icebox",978,"Ghost Gaming",116,"NRG Esports",2,12,14,9,3,1,0,1,3,10,9,4,1,0,1,4,9,10,3,"standard","2022-06-17T00:00:00.000Z","[1468,3074,1578,1780,3016]","[1597,1232,10253,165,1763]","Sova,Viper,Sage,KAY/O,Chamber","Sova,Viper,Sage,Omen,Chamber",1588
69981,31286,"VCT North America 2022 - Stage 2 Challengers - Playoffs","Breeze",978,"Ghost Gaming",116,"NRG Esports",1,7,13,6,6,1,1,0,6,6,1,7,1,1,0,7,1,6,6,"standard","2022-06-17T00:00:00.000Z","[1468,3074,3016,1780,1578]","[1597,1232,165,10253,1763]","Sova,Viper,Jett,KAY/O,Chamber","Sova,Viper,Jett,Skye,Chamber",1588
69992,31289,"VCT EMEA 2022 - Stage 2 Challengers - Playoffs","Haven",224,"Team Liquid",17,"FunPlus Phoenix",2,12,14,5,7,0,0,0,7,6,5,8,2,1,1,8,5,6,7,"standard","2022-06-17T00:00:00.000Z","[2571,1690,10211,17788,2056]","[1256,2225,2335,3043,2359]","Breach,Raze,Omen,Chamber,Fade","Raze,Sage,Omen,Chamber,Fade",1588
69991,31289,"VCT EMEA 2022 - Stage 2 Challengers - Playoffs","Icebox",224,"Team Liquid",17,"FunPlus Phoenix",1,13,8,7,5,1,0,1,7,5,6,3,1,0,1,3,6,5,7,"standard","2022-06-17T00:00:00.000Z","[1690,17788,2571,10211,2056]","[2359,2225,2335,1256,3043]","Raze,Viper,Sage,Chamber,Fade","Sova,Viper,Sage,KAY/O,Chamber",1588
69990,31289,"VCT EMEA 2022 - Stage 2 Challengers - Playoffs","Split",224,"Team Liquid",17,"FunPlus Phoenix",2,8,13,2,10,1,1,0,6,3,2,10,1,1,0,10,2,3,6,"standard","2022-06-17T00:00:00.000Z","[2571,1690,17788,10211,2056]","[1256,2225,2359,2335,3043]","Breach,Raze,Cypher,Omen,Astra","Raze,Cypher,Sage,Omen,KAY/O",1588
69988,31288,"VCT EMEA 2022 - Stage 2 Challengers - Playoffs","Breeze",2597,"Acend",6656,"M3 Champions",2,14,16,7,5,0,0,0,6,9,8,7,2,1,1,7,8,9,6,"standard","2022-06-17T00:00:00.000Z","[1268,2391,732,691,87]","[1964,1081,3135,2528,274]","Viper,Skye,Chamber,Neon,Fade","Sova,Viper,Jett,Skye,Chamber",1588
69987,31288,"VCT EMEA 2022 - Stage 2 Challengers - Playoffs","Bind",2597,"Acend",6656,"M3 Champions",1,7,13,5,7,1,0,1,5,7,2,6,1,0,1,6,2,7,5,"standard","2022-06-17T00:00:00.000Z","[691,1268,2391,87,732]","[274,1081,2528,1964,3135]","Raze,Viper,Omen,Skye,Chamber","Raze,Cypher,Sova,Omen,Skye",1588
70471,31548,"VCT 2022: APAC Stage 2 Challengers - Group Stage","Bind",15,"BOOM Esports",2600,"Oasis Gaming",1,13,8,5,7,2,1,1,5,7,8,1,0,0,0,1,8,7,5,"standard","2022-06-17T00:00:00.000Z","[3365,3361,1919,217,3363]","[9066,9067,2373,8988,8083]","Breach,Brimstone,Skye,Chamber,Neon","Raze,Viper,Brimstone,Sage,Skye",1588
70470,31548,"VCT 2022: APAC Stage 2 Challengers - Group Stage","Icebox",15,"BOOM Esports",2600,"Oasis Gaming",2,13,7,6,6,1,1,0,7,1,6,6,1,1,0,6,6,1,7,"standard","2022-06-17T00:00:00.000Z","[1919,217,3365,3361,3363]","[9066,9065,9067,8083,8988]","Sova,Killjoy,Viper,Sage,Chamber","Raze,Sova,Killjoy,Viper,KAY/O",1588
70469,31547,"VCT 2022: APAC Stage 2 Challengers - Group Stage","Haven",516,"Rex Regum Qeon",363,"Global Esports",1,13,9,8,4,2,1,1,8,4,5,5,0,0,0,5,5,4,8,"standard","2022-06-17T00:00:00.000Z","[2794,3042,9124,2097,24]","[2899,1505,1652,2829,1685]","Breach,Raze,Astra,Chamber,Fade","Breach,Raze,Sova,Astra,Chamber",1588
70468,31547,"VCT 2022: APAC Stage 2 Challengers - Group Stage","Ascent",516,"Rex Regum Qeon",363,"Global Esports",2,13,15,4,8,1,1,0,9,5,4,10,1,1,0,10,4,5,9,"standard","2022-06-17T00:00:00.000Z","[3042,9125,2097,2794,9124]","[2899,1652,2829,1505,1685]","Raze,Sova,Killjoy,Omen,Fade","Breach,Sova,Astra,KAY/O,Chamber",1588
70467,31547,"VCT 2022: APAC Stage 2 Challengers - Group Stage","Split",516,"Rex Regum Qeon",363,"Global Esports",1,13,4,10,2,1,1,0,10,2,3,2,1,1,0,2,3,2,10,"standard","2022-06-17T00:00:00.000Z","[3042,2097,24,2794,9124]","[1652,1505,2829,1685,2899]","Raze,Cypher,Sage,Omen,Skye","Breach,Raze,Omen,Chamber,Fade",1588
70465,31546,"VCT 2022: APAC Stage 2 Challengers - Group Stage","Breeze",93,"Made in Thailand",1643,"Griffin E-Sports",1,1,13,1,11,0,0,0,1,11,0,2,2,1,1,2,0,11,1,"standard","2022-06-17T00:00:00.000Z","[609,347,157,2071,2957]","[1309,3419,2170,707,796]","Sova,Viper,Jett,KAY/O,Chamber","Sova,Viper,Jett,KAY/O,Chamber",1588
70464,31546,"VCT 2022: APAC Stage 2 Challengers - Group Stage","Bind",93,"Made in Thailand",1643,"Griffin E-Sports",1,8,13,7,5,1,1,0,7,5,1,8,1,1,0,8,1,5,7,"standard","2022-06-17T00:00:00.000Z","[609,2957,347,2071,157]","[796,707,3419,2170,1309]","Raze,Viper,Brimstone,Skye,Chamber","Breach,Raze,Brimstone,Yoru,Fade",1588
69973,31283,"VCT North America 2022 - Stage 2 Challengers - Playoffs","Icebox",978,"Ghost Gaming",1448,"Evil Geniuses",2,9,13,6,6,0,0,0,3,7,6,6,2,1,1,6,6,7,3,"standard","2022-06-17T00:00:00.000Z","[1468,3074,1578,1780,3016]","[2882,3842,11672,4157,1023]","Sova,Viper,Sage,KAY/O,Chamber","Sova,Viper,Sage,Jett,Chamber",1588
69972,31283,"VCT North America 2022 - Stage 2 Challengers - Playoffs","Breeze",978,"Ghost Gaming",1448,"Evil Geniuses",1,8,13,5,7,1,0,1,5,7,3,6,1,0,1,6,3,7,5,"standard","2022-06-16T00:00:00.000Z","[1468,3074,3016,1780,1578]","[2882,3842,4157,11672,1023]","Sova,Viper,Jett,KAY/O,Chamber","Sova,Viper,Jett,KAY/O,Chamber",1588
69971,31282,"VCT North America 2022 - Stage 2 Challengers - Playoffs","Icebox",617,"FaZe Clan",305,"100 Thieves",1,11,13,9,3,0,0,0,9,3,2,10,2,1,1,10,2,3,9,"standard","2022-06-16T00:00:00.000Z","[1689,1994,789,1990,369]","[2354,269,122,1012,763]","Sova,Viper,Sage,KAY/O,Chamber","Raze,Sova,Killjoy,Viper,Sage",1588
69970,31282,"VCT North America 2022 - Stage 2 Challengers - Playoffs","Fracture",617,"FaZe Clan",305,"100 Thieves",1,13,7,9,3,1,0,1,9,3,4,4,1,0,1,4,4,3,9,"standard","2022-06-16T00:00:00.000Z","[1689,1994,1990,789,369]","[269,763,1012,122,2354]","Breach,Brimstone,KAY/O,Chamber,Neon","Breach,Raze,Brimstone,Sage,Chamber",1588
69969,31282,"VCT North America 2022 - Stage 2 Challengers - Playoffs","Split",617,"FaZe Clan",305,"100 Thieves",2,10,13,9,3,1,0,1,1,10,9,3,1,0,1,3,9,10,1,"standard","2022-06-16T00:00:00.000Z","[1689,1994,1990,789,369]","[269,2354,122,1012,763]","Breach,Astra,KAY/O,Chamber,Neon","Breach,Raze,Viper,Astra,Fade",1588
70330,31475,"VCT 2022: APAC Stage 2 Challengers - Group Stage","Icebox",4838,"Bleed Esports",4696,"Team Secret",2,13,11,8,4,0,0,0,5,7,8,4,2,1,1,4,8,7,5,"standard","2022-06-16T00:00:00.000Z","[6625,645,7877,2639,6639]","[405,3076,193,9537,2121]","Sova,Killjoy,Viper,Sage,Jett","Breach,Omen,Yoru,Chamber,Fade",1588
70329,31475,"VCT 2022: APAC Stage 2 Challengers - Group Stage","Haven",4838,"Bleed Esports",4696,"Team Secret",1,13,7,6,6,0,0,0,6,6,7,1,2,1,1,1,7,6,6,"standard","2022-06-16T00:00:00.000Z","[645,6625,2639,7877,6639]","[405,2674,9537,3076,193]","Breach,Sova,Killjoy,Omen,Jett","Sova,Killjoy,Jett,Astra,KAY/O",1588
70324,31473,"VCT 2022: APAC Stage 2 Challengers - Group Stage","Fracture",184,"Paper Rex",15,"BOOM Esports",1,13,11,6,6,2,1,1,6,6,7,5,0,0,0,5,7,6,6,"standard","2022-06-16T00:00:00.000Z","[8387,432,8385,8388,8386]","[3365,3361,1919,217,3363]","Breach,Raze,Viper,Chamber,Neon","Breach,Brimstone,KAY/O,Chamber,Neon",1588
70323,31473,"VCT 2022: APAC Stage 2 Challengers - Group Stage","Haven",184,"Paper Rex",15,"BOOM Esports",1,13,8,6,6,1,0,1,6,6,7,2,1,0,1,2,7,6,6,"standard","2022-06-16T00:00:00.000Z","[432,8387,8385,8386,8388]","[3365,1919,3361,217,3363]","Raze,Sage,Astra,Chamber,Fade","Breach,Sova,Omen,Chamber,Neon",1588
70318,31471,"VCT 2022: APAC Stage 2 Challengers - Group Stage","Breeze",5903,"XERXIA Esports",516,"Rex Regum Qeon",1,13,11,8,4,1,0,1,8,4,5,7,1,0,1,7,5,4,8,"standard","2022-06-16T00:00:00.000Z","[671,766,6890,3642,21245]","[24,9124,3042,2794,2097]","Sova,Viper,Skye,KAY/O,Chamber","Sova,Viper,Jett,Skye,Chamber",1588
70317,31471,"VCT 2022: APAC Stage 2 Challengers - Group Stage","Haven",5903,"XERXIA Esports",516,"Rex Regum Qeon",1,13,4,9,3,1,0,1,9,3,4,1,1,0,1,1,4,3,9,"standard","2022-06-16T00:00:00.000Z","[3642,6890,671,21245,766]","[2794,3042,9124,2097,24]","Breach,Sova,Killjoy,Jett,Astra","Breach,Raze,Astra,Chamber,Fade",1588
70312,31469,"VCT 2022: APAC Stage 2 Challengers - Group Stage","Fracture",667,"Onic Esports",93,"Made in Thailand",2,13,11,5,7,2,1,1,8,4,5,7,0,0,0,7,5,4,8,"standard","2022-06-16T00:00:00.000Z","[3496,3380,3583,3377,9970]","[2071,347,609,2957,157]","Brimstone,KAY/O,Chamber,Neon,Fade","Breach,Brimstone,Sage,Chamber,Neon",1588
70311,31469,"VCT 2022: APAC Stage 2 Challengers - Group Stage","Ascent",667,"Onic Esports",93,"Made in Thailand",1,13,2,10,2,2,1,1,10,2,3,0,0,0,0,0,3,2,10,"standard","2022-06-16T00:00:00.000Z","[9970,3377,3496,3380,3583]","[2957,347,157,2071,609]","Sova,Jett,Astra,KAY/O,Chamber","Killjoy,Omen,Jett,KAY/O,Fade",1588
70334,31476,"VCT 2022: APAC Stage 2 Challengers - Group Stage","Haven",4232,"FW Esports",3457,"Fancy United Esports",1,8,13,5,7,0,0,0,5,7,3,6,2,1,1,6,3,7,5,"standard","2022-06-15T00:00:00.000Z","[13608,13610,21620,16124,13609]","[13767,2556,1836,13645,3691]","Breach,Killjoy,Skye,Astra,Neon","Breach,Omen,Skye,Astra,Chamber",1588
70333,31476,"VCT 2022: APAC Stage 2 Challengers - Group Stage","Bind",4232,"FW Esports",3457,"Fancy United Esports",2,13,10,4,8,2,1,1,9,2,4,8,0,0,0,8,4,2,9,"standard","2022-06-15T00:00:00.000Z","[13608,16124,21620,13609,13610]","[13645,2556,13767,1836,3691]","Breach,Brimstone,Chamber,Neon,Fade","Viper,Omen,Skye,Astra,Chamber",1588
70332,31476,"VCT 2022: APAC Stage 2 Challengers - Group Stage","Breeze",4232,"FW Esports",3457,"Fancy United Esports",2,10,13,4,8,1,1,0,6,5,4,8,1,1,0,8,4,5,6,"standard","2022-06-15T00:00:00.000Z","[13608,16124,13609,21620,13610]","[13767,2556,1836,3691,13645]","Sova,Viper,Jett,Skye,Chamber","Cypher,Sova,Viper,Jett,KAY/O",1588
70327,31474,"VCT 2022: APAC Stage 2 Challengers - Group Stage","Ascent",2600,"Oasis Gaming",101,"ORDER",1,2,13,2,10,0,0,0,2,10,0,3,2,1,1,3,0,10,2,"standard","2022-06-15T00:00:00.000Z","[9066,8988,2373,8083,9067]","[2271,1046,2691,824,40]","Raze,Sova,Killjoy,Astra,KAY/O","Killjoy,Omen,Jett,KAY/O,Fade",1588
70326,31474,"VCT 2022: APAC Stage 2 Challengers - Group Stage","Breeze",2600,"Oasis Gaming",101,"ORDER",2,7,13,4,8,0,0,0,3,5,4,8,2,1,1,8,4,5,3,"standard","2022-06-15T00:00:00.000Z","[9065,9067,9066,8988,8083]","[40,1046,2691,824,2271]","Sova,Viper,Jett,KAY/O,Chamber","Sova,Viper,Jett,KAY/O,Chamber",1588
70321,31472,"VCT 2022: APAC Stage 2 Challengers - Group Stage","Fracture",493,"Alter Ego",363,"Global Esports",2,13,7,7,5,2,1,1,6,2,7,5,0,0,0,5,7,2,6,"standard","2022-06-15T00:00:00.000Z","[956,25261,3358,25260,9957]","[2899,1505,2829,1652,1685]","Breach,Brimstone,KAY/O,Chamber,Neon","Breach,Raze,Brimstone,Sage,Chamber",1588
70320,31472,"VCT 2022: APAC Stage 2 Challengers - Group Stage","Bind",493,"Alter Ego",363,"Global Esports",2,13,9,8,4,1,0,1,5,5,8,4,1,0,1,4,8,5,5,"standard","2022-06-15T00:00:00.000Z","[9957,25261,956,25260,3358]","[2899,1505,1652,2829,1685]","Raze,Brimstone,Skye,Chamber,Fade","Breach,Raze,Sova,Brimstone,Chamber",1588
70315,31470,"VCT 2022: APAC Stage 2 Challengers - Group Stage","Haven",7294,"Gaimin Gladiators",1643,"Griffin E-Sports",2,13,6,7,5,1,1,0,6,1,7,5,1,1,0,5,7,1,6,"standard","2022-06-15T00:00:00.000Z","[19663,13634,873,2755,16660]","[796,3419,2170,707,1309]","Breach,Sova,Killjoy,Omen,Jett","Killjoy,Omen,Jett,KAY/O,Fade",1588
70314,31470,"VCT 2022: APAC Stage 2 Challengers - Group Stage","Ascent",7294,"Gaimin Gladiators",1643,"Griffin E-Sports",1,13,10,6,6,0,0,0,6,6,7,4,2,1,1,4,7,6,6,"standard","2022-06-15T00:00:00.000Z","[13634,2755,16660,19663,873]","[707,796,2170,3419,1309]","Sova,Omen,Jett,KAY/O,Chamber","Sova,Killjoy,Jett,Astra,KAY/O",1588
65249,29234,"VCT Korea 2022 - Stage 2 Challengers - Group Stage","Ascent",6366,"Maru Gaming",6406,"CNJ Esports",2,7,13,6,6,1,0,1,1,7,6,6,1,0,1,6,6,7,1,"standard","2022-06-13T00:00:00.000Z","[8382,2762,4229,6719,6595]","[225,6692,1008,2306,6738]","Jett,Astra,KAY/O,Chamber,Fade","Raze,Omen,KAY/O,Chamber,Fade",1588
65248,29234,"VCT Korea 2022 - Stage 2 Challengers - Group Stage","Split",6366,"Maru Gaming",6406,"CNJ Esports",2,13,8,6,6,2,1,1,7,2,6,6,0,0,0,6,6,2,7,"standard","2022-06-13T00:00:00.000Z","[6595,8382,4229,2762,6719]","[1008,6738,6692,225,2306]","Breach,Raze,Sage,Omen,Fade","Raze,Sage,Omen,KAY/O,Chamber",1588
65247,29234,"VCT Korea 2022 - Stage 2 Challengers - Group Stage","Fracture",6366,"Maru Gaming",6406,"CNJ Esports",1,3,13,1,11,1,0,1,1,11,2,2,1,0,1,2,2,11,1,"standard","2022-06-13T00:00:00.000Z","[6595,2762,6719,4229,8382]","[225,1008,6692,6738,2306]","Breach,Brimstone,KAY/O,Chamber,Neon","Breach,Raze,Brimstone,Sage,Chamber",1588
65245,29233,"VCT Korea 2022 - Stage 2 Challengers - Group Stage","Haven",286,"DRX",1267,"Spear Gaming",1,13,5,9,3,1,1,0,9,3,4,2,1,1,0,2,4,3,9,"standard","2022-06-13T00:00:00.000Z","[582,814,1251,1550,452]","[8076,18840,6600,15737,18839]","Breach,Sova,Killjoy,Jett,Astra","Breach,Sova,Omen,Jett,Chamber",1588
65244,29233,"VCT Korea 2022 - Stage 2 Challengers - Group Stage","Fracture",286,"DRX",1267,"Spear Gaming",1,13,4,10,2,2,1,1,10,2,3,2,0,0,0,2,3,2,10,"standard","2022-06-13T00:00:00.000Z","[582,452,814,1251,1550]","[18840,15737,8076,6600,18839]","Breach,Brimstone,Sage,Chamber,Neon","Breach,Raze,Sage,Astra,Chamber",1588
69025,30850,"VCT Brazil 2022 - Stage 2 Challengers 1 - Group Stage","Ascent",5750,"Ninjas in Pyjamas",5675,"MIBR",1,13,6,6,6,2,1,1,6,6,7,0,0,0,0,0,7,6,6,"standard","2022-06-13T00:00:00.000Z","[16804,762,2901,3203,2195]","[11296,4577,3105,1877,211]","Sova,Killjoy,Omen,Jett,Fade","Raze,Omen,KAY/O,Chamber,Fade",1588
69024,30850,"VCT Brazil 2022 - Stage 2 Challengers 1 - Group Stage","Fracture",5750,"Ninjas in Pyjamas",5675,"MIBR",2,13,11,8,4,1,0,1,5,7,8,4,1,0,1,4,8,7,5,"standard","2022-06-13T00:00:00.000Z","[762,2901,16804,3203,2195]","[211,4577,3105,1877,11296]","Breach,Brimstone,KAY/O,Chamber,Neon","Breach,Brimstone,Sage,Chamber,Neon",1588
69023,30850,"VCT Brazil 2022 - Stage 2 Challengers 1 - Group Stage","Icebox",5750,"Ninjas in Pyjamas",5675,"MIBR",1,9,13,7,5,1,1,0,7,5,2,8,1,1,0,8,2,5,7,"standard","2022-06-12T00:00:00.000Z","[16804,2901,762,2195,3203]","[211,1877,4577,3105,11296]","Sova,Viper,Sage,Reyna,Chamber","Sova,Viper,Sage,KAY/O,Chamber",1588
69576,31088,"VCT North America 2022 - Stage 2 Challengers - Group Stage","Ascent",6426,"OpTic Gaming",279,"Luminosity Gaming",1,13,8,7,5,1,0,1,7,5,6,3,1,0,1,3,6,5,7,"standard","2022-06-12T00:00:00.000Z","[2483,398,3211,2716,2841]","[2489,3345,1522,905,1801]","Sova,Astra,KAY/O,Chamber,Fade","Sova,Killjoy,Omen,Jett,Skye",1588
69022,30849,"VCT Brazil 2022 - Stage 2 Challengers 1 - Group Stage","Haven",5747,"TBK Esports",319,"Liberty",1,13,5,7,5,1,0,1,7,5,6,0,1,0,1,0,6,5,7,"standard","2022-06-12T00:00:00.000Z","[2366,2457,9831,1506,5580]","[986,4745,2054,2927,23522]","Breach,Killjoy,Omen,Jett,Skye","Breach,Raze,Omen,Skye,Chamber",1588
69575,31088,"VCT North America 2022 - Stage 2 Challengers - Group Stage","Split",6426,"OpTic Gaming",279,"Luminosity Gaming",2,14,12,9,3,2,1,1,4,9,10,3,0,0,0,3,10,9,4,"standard","2022-06-12T00:00:00.000Z","[2841,398,2483,2716,3211]","[1801,3345,2489,1522,905]","Breach,Astra,KAY/O,Chamber,Neon","Raze,Cypher,Sage,Omen,Jett",1588
69021,30849,"VCT Brazil 2022 - Stage 2 Challengers 1 - Group Stage","Split",5747,"TBK Esports",319,"Liberty",1,10,13,6,6,0,0,0,6,6,4,7,2,1,1,7,4,6,6,"standard","2022-06-12T00:00:00.000Z","[2366,2457,5580,9831,1506]","[2927,4745,986,2054,23522]","Raze,Viper,Skye,Astra,Chamber","Breach,Raze,Sage,Omen,Chamber",1588
69570,31086,"VCT North America 2022 - Stage 2 Challengers - Group Stage","Ascent",141,"Cloud9",388,"Sentinels",1,13,7,5,7,2,1,1,5,7,8,0,0,0,0,0,8,7,5,"standard","2022-06-12T00:00:00.000Z","[3599,4639,13591,2213,3773]","[893,370,3033,1249,724]","Jett,Astra,KAY/O,Chamber,Fade","Sova,Omen,Jett,KAY/O,Chamber",1588
69020,30849,"VCT Brazil 2022 - Stage 2 Challengers 1 - Group Stage","Ascent",5747,"TBK Esports",319,"Liberty",2,13,11,9,3,1,0,1,4,8,9,3,1,0,1,3,9,8,4,"standard","2022-06-12T00:00:00.000Z","[5580,2457,2366,9831,1506]","[4745,2054,2927,23522,986]","Sova,Killjoy,Sage,Omen,Jett","Raze,Omen,KAY/O,Chamber,Fade",1588
69569,31086,"VCT North America 2022 - Stage 2 Challengers - Group Stage","Haven",141,"Cloud9",388,"Sentinels",2,13,2,10,2,2,1,1,3,0,10,2,0,0,0,2,10,0,3,"standard","2022-06-12T00:00:00.000Z","[3773,4639,3599,13591,2213]","[893,370,3033,1249,724]","Breach,Omen,Jett,Skye,Chamber","Breach,Omen,Jett,KAY/O,Chamber",1588
69894,31244,"VCT LATAM South 2022 - Stage 2 Challengers - Play-In","Split",738,"Leviatán",683,"9z Team",2,13,4,8,4,2,1,1,5,0,8,4,0,0,0,4,8,0,5,"standard","2022-06-12T00:00:00.000Z","[3531,3421,21588,3532,6414]","[855,3506,9905,1376,3510]","Breach,Astra,KAY/O,Chamber,Neon","Raze,Cypher,Sage,Omen,Skye",1588
69893,31244,"VCT LATAM South 2022 - Stage 2 Challengers - Play-In","Breeze",738,"Leviatán",683,"9z Team",1,13,2,10,2,2,1,1,10,2,3,0,0,0,0,0,3,2,10,"standard","2022-06-12T00:00:00.000Z","[3531,3421,21588,6414,3532]","[9905,1376,3506,3510,855]","Sova,Viper,Skye,KAY/O,Chamber","Sova,Viper,Skye,KAY/O,Chamber",1588
69562,31083,"VCT EMEA 2022 - Stage 2 Challengers - Group Stage","Bind",1625,"FNATIC",194,"G2 Esports (Inactive)",2,13,11,8,4,2,1,1,5,7,8,4,0,0,0,4,8,7,5,"standard","2022-06-12T00:00:00.000Z","[2937,14543,76,2011,718]","[1826,2377,2594,2769,2940]","Raze,Viper,Skye,Astra,Fade","Raze,Viper,Skye,Astra,Chamber",1588
69561,31083,"VCT EMEA 2022 - Stage 2 Challengers - Group Stage","Split",1625,"FNATIC",194,"G2 Esports (Inactive)",2,10,13,7,5,1,0,1,3,8,7,5,1,0,1,5,7,8,3,"standard","2022-06-12T00:00:00.000Z","[14543,76,2011,2937,718]","[1826,2377,2594,2769,2940]","Raze,Viper,Omen,Chamber,Fade","Raze,Cypher,Sage,Omen,Chamber",1588
69560,31083,"VCT EMEA 2022 - Stage 2 Challengers - Group Stage","Icebox",1625,"FNATIC",194,"G2 Esports (Inactive)",1,13,9,7,5,2,1,1,7,5,6,4,0,0,0,4,6,5,7,"standard","2022-06-12T00:00:00.000Z","[718,14543,2011,76,2937]","[1826,2377,2769,2594,2940]","Sova,Killjoy,Viper,Sage,Chamber","Sova,Killjoy,Viper,Sage,Chamber",1588
69558,31082,"VCT EMEA 2022 - Stage 2 Challengers - Group Stage","Haven",329,"BIG",520,"BBL Esports",2,10,13,7,5,0,0,0,3,8,7,5,2,1,1,5,7,8,3,"standard","2022-06-12T00:00:00.000Z","[819,360,2326,1538,1828]","[1749,2864,3152,1852,9643]","Breach,Killjoy,Omen,Jett,Fade","Breach,Sova,Omen,Jett,Chamber",1588
69557,31082,"VCT EMEA 2022 - Stage 2 Challengers - Group Stage","Ascent",329,"BIG",520,"BBL Esports",1,6,13,6,6,0,0,0,6,6,0,7,2,1,1,7,0,6,6,"standard","2022-06-12T00:00:00.000Z","[360,1828,2326,1538,819]","[2864,1749,9643,3152,1852]","Sova,Killjoy,Omen,Jett,KAY/O","Sova,Killjoy,Jett,Astra,KAY/O",1588
69862,31234,"VCT Japan 2022 - Stage 2 Challengers - Main Event","Icebox",444,"Crazy Raccoon",334,"REJECT",2,13,8,8,4,0,0,0,5,4,8,4,2,1,1,4,8,4,5,"standard","2022-06-12T00:00:00.000Z","[1231,815,8025,2388,1886]","[705,2791,852,3011,2584]","Sova,Viper,Sage,KAY/O,Chamber","Sova,Killjoy,Viper,Sage,Chamber",1588
65243,29232,"VCT Korea 2022 - Stage 2 Challengers - Group Stage","Icebox",5373,"On Sla2ers",1515,"World Game Star",1,3,13,3,9,0,0,0,3,9,0,4,2,1,1,4,0,9,3,"standard","2022-06-12T00:00:00.000Z","[1075,2904,1199,2009,2151]","[293,3522,2687,23167,2650]","Breach,Cypher,Killjoy,Brimstone,Astra","Sova,Viper,Jett,KAY/O,Chamber",1588
69861,31234,"VCT Japan 2022 - Stage 2 Challengers - Main Event","Ascent",444,"Crazy Raccoon",334,"REJECT",1,13,9,6,6,1,1,0,6,6,7,3,1,1,0,3,7,6,6,"standard","2022-06-12T00:00:00.000Z","[1231,2388,815,1886,8025]","[2791,705,3011,852,2584]","Sova,Killjoy,Omen,Jett,KAY/O","Sage,Omen,Jett,Chamber,Fade",1588
65242,29232,"VCT Korea 2022 - Stage 2 Challengers - Group Stage","Split",5373,"On Sla2ers",1515,"World Game Star",1,8,13,4,8,0,0,0,4,8,4,5,2,1,1,5,4,8,4,"standard","2022-06-12T00:00:00.000Z","[2151,1199,2009,1075,2904]","[23167,293,2687,3522,2650]","Breach,Phoenix,Brimstone,Reyna,Neon","Breach,Sage,Jett,Astra,Chamber",1588
65241,29232,"VCT Korea 2022 - Stage 2 Challengers - Group Stage","Bind",5373,"On Sla2ers",1515,"World Game Star",1,13,4,9,3,2,1,1,9,3,4,1,0,0,0,1,4,3,9,"standard","2022-06-12T00:00:00.000Z","[2904,2151,2009,1075,1199]","[2687,3522,293,23167,2650]","Raze,Viper,Brimstone,Sage,Skye","Breach,Omen,Skye,Chamber,Neon",1588
69856,31232,"VCT Japan 2022 - Stage 2 Challengers - Main Event","Split",444,"Crazy Raccoon",740,"BLUE BEES.ESP",2,13,6,8,4,1,0,1,5,2,8,4,1,0,1,4,8,2,5,"standard","2022-06-12T00:00:00.000Z","[8025,1886,2388,1231,815]","[23152,3966,2792,1212,23136]","Breach,Raze,Cypher,Sage,Omen","Raze,Sage,Omen,Chamber,Fade",1588
69855,31232,"VCT Japan 2022 - Stage 2 Challengers - Main Event","Ascent",444,"Crazy Raccoon",740,"BLUE BEES.ESP",1,13,10,5,7,2,1,1,5,7,8,3,0,0,0,3,8,7,5,"standard","2022-06-12T00:00:00.000Z","[1231,2388,815,1886,8025]","[3966,2792,23152,1212,23136]","Sova,Killjoy,Omen,Jett,KAY/O","Sage,Omen,Jett,KAY/O,Fade",1588
65239,29231,"VCT Korea 2022 - Stage 2 Challengers - Group Stage","Breeze",997,"DAMWON Gaming",7156,"Tartarus",1,13,6,8,4,1,1,0,8,4,5,2,1,1,0,2,5,4,8,"standard","2022-06-12T00:00:00.000Z","[2368,315,4811,6546,2240]","[679,22846,745,6740,15738]","Sova,Viper,Jett,KAY/O,Chamber","Sova,Viper,Jett,KAY/O,Chamber",1588
65238,29231,"VCT Korea 2022 - Stage 2 Challengers - Group Stage","Bind",997,"DAMWON Gaming",7156,"Tartarus",1,13,10,7,5,2,1,1,7,5,6,5,0,0,0,5,6,5,7,"standard","2022-06-12T00:00:00.000Z","[315,2240,4811,2368,6546]","[6740,745,22846,15738,679]","Breach,Brimstone,Jett,Skye,Chamber","Breach,Raze,Brimstone,Chamber,Fade",1588
69785,31189,"VCT Japan 2022 - Stage 2 Challengers - Main Event","Haven",488,"FAV gaming",334,"REJECT",1,8,13,8,4,1,1,0,8,4,0,9,1,1,0,9,0,4,8,"standard","2022-06-12T00:00:00.000Z","[9576,3035,1824,314,8883]","[705,3011,2791,852,2584]","Killjoy,Omen,Jett,Skye,Fade","Breach,Raze,Astra,Chamber,Fade",1588
69784,31189,"VCT Japan 2022 - Stage 2 Challengers - Main Event","Bind",488,"FAV gaming",334,"REJECT",2,7,13,3,9,0,0,0,4,4,3,9,2,1,1,9,3,4,4,"standard","2022-06-12T00:00:00.000Z","[1824,9576,8883,314,3035]","[705,852,2791,3011,2584]","Raze,Viper,Sage,Skye,Astra","Breach,Brimstone,Chamber,Neon,Fade",1588
69573,31087,"VCT North America 2022 - Stage 2 Challengers - Group Stage","Icebox",305,"100 Thieves",978,"Ghost Gaming",1,6,13,4,8,0,0,0,4,8,2,5,2,1,1,5,2,8,4,"standard","2022-06-12T00:00:00.000Z","[2354,269,122,1012,763]","[1468,3074,1578,1780,3016]","Raze,Sova,Killjoy,Viper,Sage","Sova,Viper,Sage,KAY/O,Chamber",1588
68822,30764,"VCT Brazil 2022 - Stage 2 Challengers 1 - Group Stage","Fracture",580,"Gamelanders Blue",6344,"LOUD",1,2,13,2,10,1,1,0,2,10,0,3,1,1,0,3,0,10,2,"standard","2022-06-12T00:00:00.000Z","[739,1113,1427,6038,4747]","[2294,4748,6037,2895,4746]","Breach,Raze,Brimstone,Chamber,Fade","Breach,Raze,Brimstone,Sage,Chamber",1588
69572,31087,"VCT North America 2022 - Stage 2 Challengers - Group Stage","Breeze",305,"100 Thieves",978,"Ghost Gaming",2,11,13,7,5,1,0,1,4,8,7,5,1,0,1,5,7,8,4,"standard","2022-06-11T00:00:00.000Z","[122,269,1012,2354,763]","[1468,3074,3016,1780,1578]","Cypher,Sova,Viper,Jett,KAY/O","Sova,Viper,Jett,KAY/O,Chamber",1588
68821,30764,"VCT Brazil 2022 - Stage 2 Challengers 1 - Group Stage","Split",580,"Gamelanders Blue",6344,"LOUD",1,15,17,6,6,0,0,0,9,7,6,10,2,1,1,10,6,7,9,"standard","2022-06-11T00:00:00.000Z","[4747,739,1427,1113,6038]","[2294,6037,2895,4746,4748]","Raze,Viper,Omen,Skye,Chamber","Breach,Astra,KAY/O,Chamber,Neon",1588
69568,31085,"VCT North America 2022 - Stage 2 Challengers - Group Stage","Split",116,"NRG Esports",5201,"The Guard",2,13,6,10,2,1,0,1,3,4,10,2,1,0,1,2,10,4,3,"standard","2022-06-11T00:00:00.000Z","[165,1232,10253,1763,1597]","[2551,4141,1091,11412,1804]","Raze,Omen,KAY/O,Chamber,Fade","Raze,Viper,Sage,Skye,Astra",1588
69196,30930,"VCT LATAM South 2022 - Stage 2 Challengers - Play-In","Haven",976,"KRÜ Esports",738,"Leviatán",2,13,10,6,6,2,1,1,7,4,6,6,0,0,0,6,6,4,7,"standard","2022-06-11T00:00:00.000Z","[4712,3535,2532,1725,4710]","[3531,6414,3421,3532,21588]","Breach,Omen,Chamber,Neon,Fade","Breach,Raze,Omen,Chamber,Fade",1588
69567,31085,"VCT North America 2022 - Stage 2 Challengers - Group Stage","Haven",116,"NRG Esports",5201,"The Guard",2,13,10,7,5,0,0,0,6,5,7,5,2,1,1,5,7,5,6,"standard","2022-06-11T00:00:00.000Z","[10253,165,1597,1232,1763]","[1091,4141,2551,1804,11412]","Breach,Raze,Sova,Astra,Chamber","Breach,Killjoy,Jett,Astra,Fade",1588
69015,30847,"VCT Brazil 2022 - Stage 2 Challengers 1 - Group Stage","Haven",1380,"Stars Horizon",5748,"Los Grandes",1,6,13,3,9,1,0,1,3,9,3,4,1,0,1,4,3,9,3,"standard","2022-06-11T00:00:00.000Z","[242,59,9801,20594,177]","[6231,4770,2103,669,2420]","Breach,Omen,Chamber,Neon,Fade","Breach,Raze,Astra,Chamber,Fade",1588
69195,30930,"VCT LATAM South 2022 - Stage 2 Challengers - Play-In","Bind",976,"KRÜ Esports",738,"Leviatán",1,13,10,7,5,1,0,1,7,5,6,5,1,0,1,5,6,5,7,"standard","2022-06-11T00:00:00.000Z","[1725,4712,3535,4710,2532]","[6414,3531,3421,21588,3532]","Raze,Viper,Brimstone,Skye,Chamber","Raze,Viper,Brimstone,Skye,Chamber",1588
69014,30847,"VCT Brazil 2022 - Stage 2 Challengers 1 - Group Stage","Icebox",1380,"Stars Horizon",5748,"Los Grandes",2,8,13,5,7,0,0,0,3,6,5,7,2,1,1,7,5,6,3,"standard","2022-06-11T00:00:00.000Z","[242,177,59,9801,20594]","[4770,6231,2103,669,2420]","Sova,Killjoy,Viper,Sage,Chamber","Sova,Viper,Sage,Chamber,Fade",1588
69566,31085,"VCT North America 2022 - Stage 2 Challengers - Group Stage","Bind",116,"NRG Esports",5201,"The Guard",1,11,13,4,8,1,0,1,4,8,7,5,1,0,1,5,7,8,4,"standard","2022-06-11T00:00:00.000Z","[10253,165,1232,1763,1597]","[2551,4141,1091,11412,1804]","Breach,Raze,Astra,Chamber,Fade","Raze,Viper,Sage,Skye,Astra",1588
69199,30931,"VCT LATAM South 2022 - Stage 2 Challengers - Play-In","Bind",1503,"Movistar Optix",683,"9z Team",2,5,13,4,8,0,0,0,1,5,4,8,2,1,1,8,4,5,1,"standard","2022-06-11T00:00:00.000Z","[3409,14764,1579,3411,14762]","[9905,855,3506,1376,3510]","Breach,Raze,Brimstone,Chamber,Fade","Breach,Raze,Viper,Brimstone,Skye",1588
69553,31080,"VCT EMEA 2022 - Stage 2 Challengers - Group Stage","Fracture",5439,"FOKUS",7050,"OG LDN UTD",2,17,15,8,4,2,1,1,7,9,10,6,0,0,0,6,10,9,7,"standard","2022-06-11T00:00:00.000Z","[3150,7669,5687,4227,20802]","[1894,2561,2199,426,2305]","Breach,Raze,Cypher,Astra,Neon","Breach,Raze,Cypher,Brimstone,Sage",1588
69198,30931,"VCT LATAM South 2022 - Stage 2 Challengers - Play-In","Haven",1503,"Movistar Optix",683,"9z Team",1,10,13,5,7,0,0,0,5,7,5,6,2,1,1,6,5,7,5,"standard","2022-06-11T00:00:00.000Z","[3409,14764,1579,3411,14762]","[9905,855,1376,3510,3506]","Breach,Raze,Astra,Chamber,Fade","Breach,Raze,Omen,Chamber,Fade",1588
69552,31080,"VCT EMEA 2022 - Stage 2 Challengers - Group Stage","Ascent",5439,"FOKUS",7050,"OG LDN UTD",2,13,11,7,5,1,0,1,6,6,7,5,1,0,1,5,7,6,6,"standard","2022-06-11T00:00:00.000Z","[3150,5687,4227,20802,7669]","[2199,2561,2305,1894,426]","Sova,Killjoy,Omen,Jett,KAY/O","Cypher,Sova,Omen,Jett,Fade",1588
69551,31080,"VCT EMEA 2022 - Stage 2 Challengers - Group Stage","Breeze",5439,"FOKUS",7050,"OG LDN UTD",1,7,13,5,7,1,1,0,5,7,2,6,1,1,0,6,2,7,5,"standard","2022-06-11T00:00:00.000Z","[5687,3150,4227,20802,7669]","[2199,426,2305,1894,2561]","Cypher,Sova,Viper,Jett,KAY/O","Cypher,Sova,Viper,Jett,Skye",1588
69556,31081,"VCT EMEA 2022 - Stage 2 Challengers - Group Stage","Haven",4220,"Natus Vincere",386,"Guild Esports",1,13,11,4,8,0,0,0,4,8,9,3,2,1,1,3,9,8,4,"standard","2022-06-11T00:00:00.000Z","[2279,2983,491,999,3003]","[2318,449,1834,2321,966]","Breach,Raze,Omen,Chamber,Fade","Breach,Sova,Killjoy,Omen,Jett",1588
69555,31081,"VCT EMEA 2022 - Stage 2 Challengers - Group Stage","Breeze",4220,"Natus Vincere",386,"Guild Esports",2,11,13,5,7,1,1,0,6,6,5,7,1,1,0,7,5,6,6,"standard","2022-06-11T00:00:00.000Z","[2279,3003,491,999,2983]","[449,2321,966,2318,1834]","Cypher,Sova,Viper,Jett,Skye","Sova,Viper,Jett,KAY/O,Chamber",1588
69554,31081,"VCT EMEA 2022 - Stage 2 Challengers - Group Stage","Icebox",4220,"Natus Vincere",386,"Guild Esports",1,13,7,5,7,1,0,1,5,7,8,0,1,0,1,0,8,7,5,"standard","2022-06-11T00:00:00.000Z","[3003,491,2279,2983,999]","[966,2321,2318,449,1834]","Sova,Viper,Sage,KAY/O,Chamber","Sova,Viper,Sage,Reyna,Jett",1588
69641,31127,"VCT Japan 2022 - Stage 2 Challengers - Main Event","Split",611,"ZETA DIVISION",488,"FAV gaming",1,13,8,9,3,2,1,1,9,3,4,5,0,0,0,5,4,3,9,"standard","2022-06-11T00:00:00.000Z","[519,2212,1593,2699,2232]","[9576,1824,314,8883,3035]","Raze,Viper,Sage,Skye,Astra","Breach,Raze,Cypher,Sage,Astra",1588
65237,29230,"VCT Korea 2022 - Stage 2 Challengers - Group Stage","Breeze",6366,"Maru Gaming",1267,"Spear Gaming",2,13,10,5,7,1,1,0,8,3,5,7,1,1,0,7,5,3,8,"standard","2022-06-11T00:00:00.000Z","[6595,2762,8382,4229,6719]","[18840,8076,6600,18839,15737]","Sova,Viper,Jett,KAY/O,Chamber","Sova,Viper,Yoru,KAY/O,Chamber",1588
69640,31127,"VCT Japan 2022 - Stage 2 Challengers - Main Event","Haven",611,"ZETA DIVISION",488,"FAV gaming",2,13,10,4,8,2,1,1,9,2,4,8,0,0,0,8,4,2,9,"standard","2022-06-11T00:00:00.000Z","[2232,519,2212,1593,2699]","[9576,3035,1824,314,8883]","Astra,KAY/O,Chamber,Neon,Fade","Killjoy,Omen,Jett,Skye,Fade",1588
65236,29230,"VCT Korea 2022 - Stage 2 Challengers - Group Stage","Bind",6366,"Maru Gaming",1267,"Spear Gaming",2,9,13,5,7,0,0,0,4,6,5,7,2,1,1,7,5,6,4,"standard","2022-06-11T00:00:00.000Z","[6595,2762,4229,8382,6719]","[15737,6600,18839,8076,18840]","Breach,Brimstone,Chamber,Neon,Fade","Raze,Cypher,Brimstone,KAY/O,Fade",1588
65235,29230,"VCT Korea 2022 - Stage 2 Challengers - Group Stage","Fracture",6366,"Maru Gaming",1267,"Spear Gaming",1,13,9,7,5,1,1,0,7,5,6,4,1,1,0,4,6,5,7,"standard","2022-06-11T00:00:00.000Z","[6595,2762,6719,4229,8382]","[18840,15737,6600,18839,8076]","Breach,Brimstone,KAY/O,Chamber,Neon","Breach,Raze,Viper,Chamber,Neon",1588
69639,31126,"VCT Japan 2022 - Stage 2 Challengers - Main Event","Haven",1840,"NORTHEPTION",444,"Crazy Raccoon",1,13,10,8,4,0,0,0,8,4,5,6,2,1,1,6,5,4,8,"standard","2022-06-11T00:00:00.000Z","[3060,2272,12341,652,8882]","[8025,1231,2388,815,1886]","Breach,Killjoy,Jett,Skye,Astra","Breach,Sova,Killjoy,Omen,Jett",1588
69638,31126,"VCT Japan 2022 - Stage 2 Challengers - Main Event","Split",1840,"NORTHEPTION",444,"Crazy Raccoon",1,10,13,6,6,2,1,1,6,6,4,7,0,0,0,7,4,6,6,"standard","2022-06-11T00:00:00.000Z","[3060,2272,8882,652,12341]","[8025,1886,2388,1231,815]","Breach,Sage,Omen,Chamber,Neon","Breach,Raze,Cypher,Sage,Omen",1588
69637,31126,"VCT Japan 2022 - Stage 2 Challengers - Main Event","Bind",1840,"NORTHEPTION",444,"Crazy Raccoon",2,13,7,6,6,2,1,1,7,1,6,6,0,0,0,6,6,1,7,"standard","2022-06-11T00:00:00.000Z","[3060,2272,652,12341,8882]","[2388,815,8025,1886,1231]","Breach,Brimstone,Chamber,Neon,Fade","Raze,Viper,Brimstone,Skye,Fade",1588
65233,29229,"VCT Korea 2022 - Stage 2 Challengers - Group Stage","Ascent",286,"DRX",6406,"CNJ Esports",1,17,15,6,6,1,1,0,8,8,9,7,1,1,0,7,9,8,8,"standard","2022-06-11T00:00:00.000Z","[814,452,1550,1251,582]","[225,6692,1008,2306,6738]","Sova,Astra,KAY/O,Chamber,Fade","Raze,Omen,KAY/O,Chamber,Fade",1588
65232,29229,"VCT Korea 2022 - Stage 2 Challengers - Group Stage","Split",286,"DRX",6406,"CNJ Esports",2,13,11,5,7,1,0,1,8,4,5,7,1,0,1,7,5,4,8,"standard","2022-06-11T00:00:00.000Z","[582,814,452,1251,1550]","[1008,6738,6692,225,2306]","Breach,Sage,Omen,Chamber,Neon","Raze,Sage,Omen,KAY/O,Chamber",1588
69635,31125,"VCT Japan 2022 - Stage 2 Challengers - Main Event","Haven",740,"BLUE BEES.ESP",206,"Sengoku Gaming",2,13,8,8,4,1,1,0,5,4,8,4,1,1,0,4,8,4,5,"standard","2022-06-11T00:00:00.000Z","[3966,23152,2792,23136,1212]","[2978,25177,9539,15518,9540]","Breach,Raze,Omen,Skye,Chamber","Killjoy,Reyna,Omen,Jett,Skye",1588
69634,31125,"VCT Japan 2022 - Stage 2 Challengers - Main Event","Bind",740,"BLUE BEES.ESP",206,"Sengoku Gaming",1,13,10,6,6,2,1,1,6,6,7,4,0,0,0,4,7,6,6,"standard","2022-06-11T00:00:00.000Z","[23152,1212,2792,3966,23136]","[9540,9539,25177,15518,2978]","Raze,Sage,Omen,Skye,Fade","Raze,Brimstone,Skye,Chamber,Fade",1588
69624,31121,"VCT Japan 2022 - Stage 2 Challengers - Main Event","Icebox",5218,"Jadeite",334,"REJECT",1,12,14,9,3,2,1,1,9,4,3,10,0,0,0,10,3,4,9,"standard","2022-06-11T00:00:00.000Z","[147,1917,12282,1746,371]","[705,852,2791,3011,2584]","Sova,Viper,Sage,Jett,Chamber","Sova,Viper,Reyna,Chamber,Fade",1588
69623,31121,"VCT Japan 2022 - Stage 2 Challengers - Main Event","Haven",5218,"Jadeite",334,"REJECT",2,3,13,3,9,0,0,0,0,4,3,9,2,1,1,9,3,4,0,"standard","2022-06-11T00:00:00.000Z","[147,12282,371,1746,1917]","[705,3011,2791,852,2584]","Breach,Sova,Killjoy,Jett,Astra","Breach,Raze,Astra,Chamber,Fade",1588
69622,31121,"VCT Japan 2022 - Stage 2 Challengers - Main Event","Bind",5218,"Jadeite",334,"REJECT",1,13,11,9,3,0,0,0,9,3,4,8,2,1,1,8,4,3,9,"standard","2022-06-11T00:00:00.000Z","[1746,1917,371,12282,147]","[2791,2584,852,705,3011]","Raze,Viper,Brimstone,Sage,Skye","Raze,Viper,Brimstone,Skye,Fade",1588
69030,30852,"VCT North America 2022 - Stage 2 Challengers - Group Stage","Breeze",617,"FaZe Clan",1448,"Evil Geniuses",1,13,9,3,9,1,0,1,3,9,10,0,1,0,1,0,10,9,3,"standard","2022-06-10T00:00:00.000Z","[1689,1994,1990,789,369]","[2882,3842,4157,11672,1023]","Sova,Viper,KAY/O,Chamber,Neon","Sova,Viper,Jett,KAY/O,Chamber",1588
69029,30852,"VCT North America 2022 - Stage 2 Challengers - Group Stage","Icebox",617,"FaZe Clan",1448,"Evil Geniuses",2,15,13,9,3,1,0,1,4,10,11,3,1,0,1,3,11,10,4,"standard","2022-06-10T00:00:00.000Z","[1689,1994,789,1990,369]","[2882,3842,11672,4157,1023]","Sova,Viper,Sage,KAY/O,Chamber","Sova,Viper,Sage,Jett,Chamber",1588
69027,30851,"VCT North America 2022 - Stage 2 Challengers - Group Stage","Haven",603,"XSET",278,"TSM",1,13,9,8,4,2,1,1,8,4,5,5,0,0,0,5,5,4,8,"standard","2022-06-10T00:00:00.000Z","[494,3062,3582,3346,1802]","[5305,2479,4239,2098,1217]","Breach,Omen,Jett,Skye,Chamber","Breach,Phoenix,Jett,Astra,Chamber",1588
69026,30851,"VCT North America 2022 - Stage 2 Challengers - Group Stage","Split",603,"XSET",278,"TSM",1,13,9,7,5,1,0,1,7,5,6,4,1,0,1,4,6,5,7,"standard","2022-06-10T00:00:00.000Z","[3582,3062,3346,494,1802]","[2479,4239,5305,2098,1217]","Raze,Viper,Skye,Astra,Chamber","Raze,Jett,Skye,Astra,Chamber",1588
69549,31079,"VCT EMEA 2022 - Stage 2 Challengers - Group Stage","Fracture",6656,"M3 Champions",224,"Team Liquid",1,7,13,3,9,0,0,0,3,9,4,4,2,1,1,4,4,9,3,"standard","2022-06-10T00:00:00.000Z","[1964,3135,1081,274,2528]","[2571,1690,10211,2056,17788]","Breach,Raze,Cypher,Brimstone,Sage","Breach,Raze,Skye,Astra,Chamber",1588
69548,31079,"VCT EMEA 2022 - Stage 2 Challengers - Group Stage","Icebox",6656,"M3 Champions",224,"Team Liquid",2,8,13,4,8,1,0,1,4,5,4,8,1,0,1,8,4,5,4,"standard","2022-06-10T00:00:00.000Z","[1964,1081,274,2528,3135]","[1690,17788,2571,10211,2056]","Sova,Viper,Brimstone,KAY/O,Chamber","Raze,Viper,Sage,Chamber,Fade",1588
69547,31078,"VCT EMEA 2022 - Stage 2 Challengers - Group Stage","Split",2597,"Acend",17,"FunPlus Phoenix",2,13,10,7,5,1,1,0,6,5,7,5,1,1,0,5,7,5,6,"standard","2022-06-10T00:00:00.000Z","[691,1268,87,2391,732]","[3043,1256,2225,2335,2359]","Raze,Cypher,Sage,Omen,Chamber","Breach,Raze,Cypher,Omen,Fade",1588
69546,31078,"VCT EMEA 2022 - Stage 2 Challengers - Group Stage","Breeze",2597,"Acend",17,"FunPlus Phoenix",2,9,13,3,9,0,0,0,6,4,3,9,2,1,1,9,3,4,6,"standard","2022-06-10T00:00:00.000Z","[1268,2391,732,691,87]","[2225,2335,1256,3043,2359]","Viper,Skye,Chamber,Neon,Fade","Viper,Yoru,KAY/O,Chamber,Fade",1588
69545,31078,"VCT EMEA 2022 - Stage 2 Challengers - Group Stage","Bind",2597,"Acend",17,"FunPlus Phoenix",1,13,6,8,4,1,1,0,8,4,5,2,1,1,0,2,5,4,8,"standard","2022-06-10T00:00:00.000Z","[691,1268,2391,87,732]","[1256,2225,2335,3043,2359]","Raze,Viper,Omen,Skye,Chamber","Raze,Cypher,Omen,KAY/O,Fade",1588
69289,30977,"VCT Japan 2022 - Stage 2 Challengers - Main Event","Breeze",206,"Sengoku Gaming",488,"FAV gaming",2,7,13,7,5,1,0,1,0,8,7,5,1,0,1,5,7,8,0,"standard","2022-06-10T00:00:00.000Z","[2978,9539,15518,9540,25177]","[8883,3035,1824,9576,314]","Sova,Viper,Jett,Skye,Chamber","Sova,Viper,Jett,KAY/O,Chamber",1588
69288,30977,"VCT Japan 2022 - Stage 2 Challengers - Main Event","Icebox",206,"Sengoku Gaming",488,"FAV gaming",2,2,13,2,10,0,0,0,0,3,2,10,2,1,1,10,2,3,0,"standard","2022-06-10T00:00:00.000Z","[9539,25177,15518,9540,2978]","[9576,3035,8883,1824,314]","Viper,Reyna,Jett,KAY/O,Fade","Sova,Viper,Sage,Jett,KAY/O",1588
69286,30976,"VCT Japan 2022 - Stage 2 Challengers - Main Event","Bind",611,"ZETA DIVISION",740,"BLUE BEES.ESP",1,16,14,4,8,1,0,1,5,10,11,4,1,0,1,4,11,10,5,"standard","2022-06-10T00:00:00.000Z","[519,2232,1593,2212,2699]","[23152,1212,2792,3966,23136]","Raze,Viper,Omen,Chamber,Fade","Raze,Sage,Omen,Skye,Fade",1588
69285,30976,"VCT Japan 2022 - Stage 2 Challengers - Main Event","Split",611,"ZETA DIVISION",740,"BLUE BEES.ESP",2,13,6,10,2,1,0,1,3,4,10,2,1,0,1,2,10,4,3,"standard","2022-06-10T00:00:00.000Z","[519,2212,1593,2699,2232]","[23152,3966,2792,1212,23136]","Raze,Viper,Sage,Skye,Astra","Raze,Sage,Omen,Chamber,Fade",1588
69283,30975,"VCT Japan 2022 - Stage 2 Challengers - Main Event","Bind",444,"Crazy Raccoon",334,"REJECT",1,13,10,9,3,1,1,0,9,3,4,7,1,1,0,7,4,3,9,"standard","2022-06-10T00:00:00.000Z","[2388,815,8025,1886,1231]","[2791,2584,852,705,3011]","Raze,Viper,Brimstone,Skye,Fade","Raze,Viper,Brimstone,Skye,Fade",1588
69282,30975,"VCT Japan 2022 - Stage 2 Challengers - Main Event","Ascent",444,"Crazy Raccoon",334,"REJECT",2,13,2,10,2,2,1,1,3,0,10,2,0,0,0,2,10,0,3,"standard","2022-06-10T00:00:00.000Z","[1231,2388,815,1886,8025]","[705,852,2791,3011,2584]","Sova,Killjoy,Omen,Jett,KAY/O","Breach,Omen,Yoru,Chamber,Fade",1588
69281,30974,"VCT Japan 2022 - Stage 2 Challengers - Main Event","Ascent",1840,"NORTHEPTION",5218,"Jadeite",2,13,10,6,6,1,1,0,7,4,6,6,1,1,0,6,6,4,7,"standard","2022-06-10T00:00:00.000Z","[2272,8882,652,12341,3060]","[12282,1917,371,1746,147]","Killjoy,Astra,KAY/O,Chamber,Fade","Sage,Omen,KAY/O,Chamber,Fade",1588
69280,30974,"VCT Japan 2022 - Stage 2 Challengers - Main Event","Split",1840,"NORTHEPTION",5218,"Jadeite",2,13,8,6,6,2,1,1,7,2,6,6,0,0,0,6,6,2,7,"standard","2022-06-10T00:00:00.000Z","[3060,2272,8882,652,12341]","[147,1746,371,12282,1917]","Breach,Sage,Omen,Chamber,Neon","Breach,Raze,Cypher,Sage,Omen",1588
69279,30974,"VCT Japan 2022 - Stage 2 Challengers - Main Event","Haven",1840,"NORTHEPTION",5218,"Jadeite",1,6,13,2,10,0,0,0,2,10,4,3,2,1,1,3,4,10,2,"standard","2022-06-10T00:00:00.000Z","[3060,2272,12341,652,8882]","[147,12282,371,1746,1917]","Breach,Killjoy,Jett,Skye,Astra","Breach,Sova,Killjoy,Jett,Astra",1588
65231,29228,"VCT Korea 2022 - Stage 2 Challengers - Group Stage","Ascent",997,"DAMWON Gaming",1515,"World Game Star",1,13,4,9,3,2,1,1,9,3,4,1,0,0,0,1,4,3,9,"standard","2022-06-06T00:00:00.000Z","[2368,2240,4811,6546,315]","[293,2687,23167,3522,2650]","Sova,Omen,Jett,KAY/O,Fade","Sova,Jett,Skye,Astra,Chamber",1588
65230,29228,"VCT Korea 2022 - Stage 2 Challengers - Group Stage","Split",997,"DAMWON Gaming",1515,"World Game Star",1,13,3,9,3,1,0,1,9,3,4,0,1,0,1,0,4,3,9,"standard","2022-06-06T00:00:00.000Z","[315,2368,2240,4811,6546]","[23167,293,2687,3522,2650]","Breach,Sage,Omen,Jett,Chamber","Breach,Sage,Jett,Astra,Chamber",1588
65229,29228,"VCT Korea 2022 - Stage 2 Challengers - Group Stage","Bind",997,"DAMWON Gaming",1515,"World Game Star",1,9,13,8,4,1,1,0,8,4,1,9,1,1,0,9,1,4,8,"standard","2022-06-06T00:00:00.000Z","[315,4811,2240,2368,6546]","[2687,3522,293,23167,2650]","Breach,Raze,Brimstone,Skye,Chamber","Breach,Omen,Skye,Chamber,Neon",1588
65227,29227,"VCT Korea 2022 - Stage 2 Challengers - Group Stage","Breeze",5373,"On Sla2ers",7156,"Tartarus",1,13,4,8,4,2,1,1,8,4,5,0,0,0,0,0,5,4,8,"standard","2022-06-06T00:00:00.000Z","[2151,1199,2009,1075,2904]","[679,22846,745,6740,15738]","Cypher,Sova,Viper,Jett,KAY/O","Sova,Viper,Jett,KAY/O,Chamber",1588
65226,29227,"VCT Korea 2022 - Stage 2 Challengers - Group Stage","Bind",5373,"On Sla2ers",7156,"Tartarus",1,13,3,9,3,1,0,1,9,3,4,0,1,0,1,0,4,3,9,"standard","2022-06-06T00:00:00.000Z","[2904,2151,2009,1075,1199]","[6740,745,22846,15738,679]","Raze,Viper,Brimstone,Sage,Skye","Breach,Raze,Brimstone,Chamber,Fade",1588
68493,30633,"VCT North America 2022 - Stage 2 Challengers - Group Stage","Icebox",141,"Cloud9",279,"Luminosity Gaming",1,9,13,7,5,1,1,0,7,5,2,8,1,1,0,8,2,5,7,"standard","2022-06-05T00:00:00.000Z","[4639,2213,3773,3599,13591]","[1522,3345,2489,1801,905]","Viper,Sage,KAY/O,Chamber,Fade","Sova,Viper,Sage,Jett,Chamber",1588
68994,30840,"VCT Brazil 2022 - Stage 2 Challengers 1 - Group Stage","Bind",1380,"Stars Horizon",6344,"LOUD",2,9,13,3,9,1,1,0,6,4,3,9,1,1,0,9,3,4,6,"standard","2022-06-05T00:00:00.000Z","[242,59,9801,20594,177]","[4748,4746,6037,2895,2294]","Breach,Brimstone,Chamber,Neon,Fade","Raze,Viper,Brimstone,Skye,Fade",1588
68993,30840,"VCT Brazil 2022 - Stage 2 Challengers 1 - Group Stage","Fracture",1380,"Stars Horizon",6344,"LOUD",1,0,13,0,12,0,0,0,0,12,0,1,2,1,1,1,0,12,0,"standard","2022-06-05T00:00:00.000Z","[242,20594,177,59,9801]","[2294,4748,6037,2895,4746]","Breach,Raze,Cypher,Brimstone,Chamber","Breach,Raze,Brimstone,Sage,Chamber",1588
68492,30633,"VCT North America 2022 - Stage 2 Challengers - Group Stage","Fracture",141,"Cloud9",279,"Luminosity Gaming",2,11,13,4,8,0,0,0,7,5,4,8,2,1,1,8,4,5,7,"standard","2022-06-05T00:00:00.000Z","[3773,13591,4639,2213,3599]","[2489,3345,1522,905,1801]","Breach,Raze,Brimstone,Sage,Chamber","Breach,Brimstone,KAY/O,Chamber,Neon",1588
68991,30839,"VCT Brazil 2022 - Stage 2 Challengers 1 - Group Stage","Haven",1264,"FURIA",580,"Gamelanders Blue",1,13,10,8,4,1,1,0,8,4,5,6,1,1,0,6,5,4,8,"standard","2022-06-05T00:00:00.000Z","[18192,2752,2749,6039,2423]","[1113,739,4747,1427,6038]","Breach,Killjoy,Omen,Skye,Neon","Breach,Cypher,Sova,Omen,Neon",1588
68490,30632,"VCT North America 2022 - Stage 2 Challengers - Group Stage","Bind",116,"NRG Esports",305,"100 Thieves",2,4,13,3,9,1,0,1,1,4,3,9,1,0,1,9,3,4,1,"standard","2022-06-05T00:00:00.000Z","[10253,1232,1763,165,1597]","[2354,122,1012,269,763]","Breach,Astra,Chamber,Neon,Fade","Raze,Viper,Brimstone,Sage,Skye",1588
68990,30839,"VCT Brazil 2022 - Stage 2 Challengers 1 - Group Stage","Breeze",1264,"FURIA",580,"Gamelanders Blue",2,13,11,3,9,1,1,0,10,2,3,9,1,1,0,9,3,2,10,"standard","2022-06-05T00:00:00.000Z","[18192,2749,6039,2752,2423]","[739,4747,1427,1113,6038]","Sova,Viper,Jett,KAY/O,Chamber","Cypher,Sova,Viper,KAY/O,Neon",1588
68489,30632,"VCT North America 2022 - Stage 2 Challengers - Group Stage","Icebox",116,"NRG Esports",305,"100 Thieves",1,9,13,6,6,0,0,0,6,6,3,7,2,1,1,7,3,6,6,"standard","2022-06-05T00:00:00.000Z","[1597,1232,10253,165,1763]","[2354,269,122,1012,763]","Sova,Viper,Sage,Omen,Chamber","Raze,Sova,Killjoy,Viper,Sage",1588
68834,30768,"VCT LATAM South 2022 - Stage 2 Challengers - Group Stage","Ascent",1503,"Movistar Optix",976,"KRÜ Esports",2,7,13,4,8,1,1,0,3,5,4,8,1,1,0,8,4,5,3,"standard","2022-06-05T00:00:00.000Z","[3409,1579,14764,3411,14762]","[1725,4712,3535,2532,4710]","Sova,Killjoy,Jett,Astra,KAY/O","Raze,Sova,Omen,Chamber,Fade",1588
68833,30768,"VCT LATAM South 2022 - Stage 2 Challengers - Group Stage","Haven",1503,"Movistar Optix",976,"KRÜ Esports",1,8,13,4,8,2,1,1,4,8,4,5,0,0,0,5,4,8,4,"standard","2022-06-05T00:00:00.000Z","[14762,1579,3409,14764,3411]","[4712,3535,2532,1725,4710]","Breach,Cypher,Sova,Jett,Astra","Breach,Omen,Chamber,Neon,Fade",1588
68511,30639,"VCT EMEA 2022 - Stage 2 Challengers - Group Stage","Bind",5439,"FOKUS",1625,"FNATIC",2,4,13,2,10,0,0,0,2,3,2,10,2,1,1,10,2,3,2,"standard","2022-06-05T00:00:00.000Z","[7669,5687,3150,20802,4227]","[2937,14543,76,2011,718]","Raze,Viper,Brimstone,Jett,Skye","Raze,Viper,Skye,Astra,Fade",1588
68510,30639,"VCT EMEA 2022 - Stage 2 Challengers - Group Stage","Split",5439,"FOKUS",1625,"FNATIC",2,7,13,5,7,2,1,1,2,6,5,7,0,0,0,7,5,6,2,"standard","2022-06-05T00:00:00.000Z","[7669,5687,3150,20802,4227]","[14543,76,2011,2937,718]","Raze,Cypher,Sage,Reyna,Omen","Raze,Viper,Omen,Chamber,Fade",1588
68508,30638,"VCT EMEA 2022 - Stage 2 Challengers - Group Stage","Ascent",520,"BBL Esports",386,"Guild Esports",1,10,13,4,8,2,1,1,4,8,6,5,0,0,0,5,6,8,4,"standard","2022-06-05T00:00:00.000Z","[2864,1749,9643,3152,1852]","[449,966,2321,1834,2318]","Sova,Killjoy,Jett,Astra,KAY/O","Sova,Killjoy,Omen,Jett,KAY/O",1588
68507,30638,"VCT EMEA 2022 - Stage 2 Challengers - Group Stage","Bind",520,"BBL Esports",386,"Guild Esports",2,12,14,5,7,2,1,1,7,6,5,8,0,0,0,8,5,6,7,"standard","2022-06-05T00:00:00.000Z","[3152,2864,1852,1749,9643]","[966,1834,2321,2318,449]","Viper,Brimstone,Sage,Skye,Chamber","Raze,Viper,Brimstone,Skye,KAY/O",1588
65225,29226,"VCT Korea 2022 - Stage 2 Challengers - Group Stage","Haven",6406,"CNJ Esports",1267,"Spear Gaming",1,10,13,5,7,1,1,0,5,7,5,6,1,1,0,6,5,7,5,"standard","2022-06-05T00:00:00.000Z","[225,1008,6692,2306,6738]","[8076,18840,6600,18839,15737]","Breach,Skye,Astra,Chamber,Neon","Breach,Sova,Killjoy,Omen,Jett",1588
65224,29226,"VCT Korea 2022 - Stage 2 Challengers - Group Stage","Icebox",6406,"CNJ Esports",1267,"Spear Gaming",1,11,13,6,6,1,0,1,6,6,5,7,1,0,1,7,5,6,6,"standard","2022-06-05T00:00:00.000Z","[6738,6692,2306,225,1008]","[18840,8076,18839,6600,15737]","Sova,Viper,Reyna,Chamber,Fade","Sova,Viper,Reyna,Jett,Chamber",1588
65223,29226,"VCT Korea 2022 - Stage 2 Challengers - Group Stage","Ascent",6406,"CNJ Esports",1267,"Spear Gaming",2,13,8,6,6,2,1,1,7,2,6,6,0,0,0,6,6,2,7,"standard","2022-06-05T00:00:00.000Z","[225,6692,1008,2306,6738]","[15737,18839,8076,6600,18840]","Raze,Omen,KAY/O,Chamber,Fade","Raze,Omen,KAY/O,Chamber,Fade",1588
65221,29225,"VCT Korea 2022 - Stage 2 Challengers - Group Stage","Ascent",286,"DRX",6366,"Maru Gaming",1,13,4,8,4,1,0,1,8,4,5,0,1,0,1,0,5,4,8,"standard","2022-06-05T00:00:00.000Z","[814,452,1550,1251,582]","[8382,2762,4229,6719,6595]","Sova,Astra,KAY/O,Chamber,Fade","Jett,Astra,KAY/O,Chamber,Fade",1588
65220,29225,"VCT Korea 2022 - Stage 2 Challengers - Group Stage","Haven",286,"DRX",6366,"Maru Gaming",1,13,4,9,3,1,0,1,9,3,4,1,1,0,1,1,4,3,9,"standard","2022-06-05T00:00:00.000Z","[582,814,1251,1550,452]","[6595,2762,8382,6719,4229]","Breach,Sova,Killjoy,Jett,Astra","Breach,Omen,Jett,Skye,Chamber",1588
68517,30641,"VCT Brazil 2022 - Stage 2 Challengers 1 - Group Stage","Breeze",600,"Keyd Stars",5747,"TBK Esports",2,13,6,8,4,0,0,0,5,2,8,4,2,1,1,4,8,2,5,"standard","2022-06-05T00:00:00.000Z","[957,4771,5288,81,277]","[5580,2457,9831,1506,2366]","Sova,Viper,Jett,Skye,Chamber","Sova,Viper,Omen,Chamber,Neon",1588
68516,30641,"VCT Brazil 2022 - Stage 2 Challengers 1 - Group Stage","Haven",600,"Keyd Stars",5747,"TBK Esports",1,13,10,7,5,1,1,0,7,5,6,5,1,1,0,5,6,5,7,"standard","2022-06-04T00:00:00.000Z","[957,81,4771,277,5288]","[2366,2457,9831,1506,5580]","Breach,Raze,Omen,Skye,Chamber","Breach,Killjoy,Omen,Jett,Skye",1588
68487,30631,"VCT North America 2022 - Stage 2 Challengers - Group Stage","Split",278,"TSM",978,"Ghost Gaming",1,13,15,7,5,1,1,0,8,6,5,9,1,1,0,9,5,6,8,"standard","2022-06-04T00:00:00.000Z","[4239,5305,2479,2098,1217]","[1468,1780,3074,3016,1578]","Raze,Viper,Skye,Astra,Chamber","Breach,Raze,Astra,Chamber,Fade",1588
67876,30394,"VCT LATAM South 2022 - Stage 2 Challengers - Group Stage","Bind",683,"9z Team",738,"Leviatán",2,4,13,3,9,0,0,0,1,4,3,9,2,1,1,9,3,4,1,"standard","2022-06-04T00:00:00.000Z","[9905,855,1376,3510,3506]","[6414,3531,3421,21588,3532]","Breach,Raze,Brimstone,Skye,Chamber","Raze,Viper,Brimstone,Skye,Chamber",1588
68486,30631,"VCT North America 2022 - Stage 2 Challengers - Group Stage","Breeze",278,"TSM",978,"Ghost Gaming",2,9,13,7,5,2,1,1,2,8,7,5,0,0,0,5,7,8,2,"standard","2022-06-04T00:00:00.000Z","[1217,5305,2098,4239,2479]","[1468,3074,3016,1780,1578]","Cypher,Sova,Viper,Jett,Skye","Sova,Viper,Jett,KAY/O,Chamber",1588
68515,30640,"VCT Brazil 2022 - Stage 2 Challengers 1 - Group Stage","Fracture",319,"Liberty",5675,"MIBR",1,8,13,4,8,1,0,1,4,8,4,5,1,0,1,5,4,8,4,"standard","2022-06-04T00:00:00.000Z","[986,2054,2927,23522,4745]","[211,4577,3105,1877,11296]","Breach,Brimstone,KAY/O,Chamber,Neon","Breach,Brimstone,Sage,Chamber,Neon",1588
67875,30394,"VCT LATAM South 2022 - Stage 2 Challengers - Group Stage","Haven",683,"9z Team",738,"Leviatán",1,11,13,7,5,0,0,0,7,5,4,8,2,1,1,8,4,5,7,"standard","2022-06-04T00:00:00.000Z","[9905,855,1376,3510,3506]","[3531,3421,21588,3532,6414]","Breach,Raze,Omen,Chamber,Fade","Breach,Omen,Skye,Chamber,Neon",1588
68514,30640,"VCT Brazil 2022 - Stage 2 Challengers 1 - Group Stage","Bind",319,"Liberty",5675,"MIBR",1,11,13,7,5,1,1,0,7,5,4,8,1,1,0,8,4,5,7,"standard","2022-06-04T00:00:00.000Z","[986,2054,23522,4745,2927]","[11296,4577,3105,211,1877]","Breach,Brimstone,Chamber,Neon,Fade","Raze,Viper,Brimstone,Skye,Chamber",1588
68484,30630,"VCT North America 2022 - Stage 2 Challengers - Group Stage","Haven",388,"Sentinels",617,"FaZe Clan",1,14,16,7,5,2,1,1,8,7,6,9,0,0,0,9,6,7,8,"standard","2022-06-04T00:00:00.000Z","[893,370,3033,1249,724]","[1689,1994,1990,789,369]","Breach,Omen,Jett,KAY/O,Chamber","Breach,Omen,Skye,Chamber,Neon",1588
67874,30393,"VCT LATAM South 2022 - Stage 2 Challengers - Group Stage","Bind",5106,"PAMPAS",976,"KRÜ Esports",1,4,13,4,8,1,1,0,4,8,0,5,1,1,0,5,0,8,4,"standard","2022-06-04T00:00:00.000Z","[4601,5709,3538,3718,32]","[1725,4712,3535,4710,2532]","Breach,Raze,Brimstone,Chamber,Fade","Raze,Viper,Brimstone,Skye,Chamber",1588
68513,30640,"VCT Brazil 2022 - Stage 2 Challengers 1 - Group Stage","Ascent",319,"Liberty",5675,"MIBR",2,13,5,8,4,2,1,1,5,1,8,4,0,0,0,4,8,1,5,"standard","2022-06-04T00:00:00.000Z","[4745,2054,2927,23522,986]","[1877,4577,3105,11296,211]","Raze,Omen,KAY/O,Chamber,Fade","Sage,Omen,KAY/O,Chamber,Fade",1588
68483,30630,"VCT North America 2022 - Stage 2 Challengers - Group Stage","Fracture",388,"Sentinels",617,"FaZe Clan",2,11,13,4,8,1,1,0,7,5,4,8,1,1,0,8,4,5,7,"standard","2022-06-04T00:00:00.000Z","[893,370,724,3033,1249]","[1689,1994,1990,789,369]","Breach,Brimstone,Sage,Yoru,Chamber","Breach,Brimstone,KAY/O,Chamber,Neon",1588
67873,30393,"VCT LATAM South 2022 - Stage 2 Challengers - Group Stage","Ascent",5106,"PAMPAS",976,"KRÜ Esports",1,5,13,3,9,0,0,0,3,9,2,4,2,1,1,4,2,9,3,"standard","2022-06-04T00:00:00.000Z","[32,3718,3538,5709,4601]","[1725,4712,3535,2532,4710]","Sova,Killjoy,Omen,Jett,KAY/O","Raze,Sova,Omen,Chamber,Fade",1588
67872,30393,"VCT LATAM South 2022 - Stage 2 Challengers - Group Stage","Haven",5106,"PAMPAS",976,"KRÜ Esports",2,13,10,7,5,1,0,1,6,5,7,5,1,0,1,5,7,5,6,"standard","2022-06-04T00:00:00.000Z","[4601,5709,3718,32,3538]","[4712,3535,2532,1725,4710]","Breach,Raze,Cypher,Sova,Omen","Breach,Omen,Chamber,Neon,Fade",1588
68505,30637,"VCT EMEA 2022 - Stage 2 Challengers - Group Stage","Bind",7050,"OG LDN UTD",17,"FunPlus Phoenix",2,3,13,3,9,1,0,1,0,4,3,9,1,0,1,9,3,4,0,"standard","2022-06-04T00:00:00.000Z","[2305,2199,1894,2561,426]","[1256,2225,2335,3043,2359]","Breach,Brimstone,Chamber,Neon,Fade","Raze,Cypher,Brimstone,KAY/O,Fade",1588
68504,30637,"VCT EMEA 2022 - Stage 2 Challengers - Group Stage","Haven",7050,"OG LDN UTD",17,"FunPlus Phoenix",1,6,13,3,9,0,0,0,3,9,3,4,2,1,1,4,3,9,3,"standard","2022-06-04T00:00:00.000Z","[426,2199,2305,1894,2561]","[1256,2225,2335,3043,2359]","Breach,Raze,Omen,Chamber,Fade","Raze,Sage,Omen,Chamber,Fade",1588
68502,30636,"VCT EMEA 2022 - Stage 2 Challengers - Group Stage","Bind",329,"BIG",6656,"M3 Champions",1,13,9,7,5,1,0,1,7,5,6,4,1,0,1,4,6,5,7,"standard","2022-06-04T00:00:00.000Z","[1538,2326,360,1828,819]","[3135,1081,274,2528,1964]","Raze,Brimstone,Skye,Chamber,Fade","Raze,Viper,Brimstone,Skye,Fade",1588
68501,30636,"VCT EMEA 2022 - Stage 2 Challengers - Group Stage","Ascent",329,"BIG",6656,"M3 Champions",2,13,9,9,3,1,0,1,4,6,9,3,1,0,1,3,9,6,4,"standard","2022-06-04T00:00:00.000Z","[360,1828,2326,1538,819]","[2528,274,3135,1081,1964]","Sova,Killjoy,Omen,Jett,KAY/O","Sova,Killjoy,Jett,Astra,KAY/O",1588
65219,29224,"VCT Korea 2022 - Stage 2 Challengers - Group Stage","Fracture",997,"DAMWON Gaming",5373,"On Sla2ers",2,3,13,2,10,0,0,0,1,3,2,10,2,1,1,10,2,3,1,"standard","2022-06-04T00:00:00.000Z","[315,6546,2240,2368,4811]","[2904,2009,1199,2151,1075]","Breach,Raze,Astra,KAY/O,Chamber","Breach,Brimstone,KAY/O,Chamber,Neon",1588
65218,29224,"VCT Korea 2022 - Stage 2 Challengers - Group Stage","Bind",997,"DAMWON Gaming",5373,"On Sla2ers",2,10,13,6,6,0,0,0,4,7,6,6,2,1,1,6,6,7,4,"standard","2022-06-04T00:00:00.000Z","[315,6546,2240,2368,4811]","[2904,2151,2009,1075,1199]","Breach,Raze,Brimstone,Skye,Chamber","Raze,Viper,Brimstone,Sage,Skye",1588
65217,29224,"VCT Korea 2022 - Stage 2 Challengers - Group Stage","Breeze",997,"DAMWON Gaming",5373,"On Sla2ers",1,13,2,10,2,2,1,1,10,2,3,0,0,0,0,0,3,2,10,"standard","2022-06-04T00:00:00.000Z","[2368,315,2240,6546,4811]","[2151,1199,2009,1075,2904]","Sova,Viper,Astra,KAY/O,Chamber","Cypher,Sova,Viper,Yoru,KAY/O",1588
65215,29223,"VCT Korea 2022 - Stage 2 Challengers - Group Stage","Haven",1515,"World Game Star",7156,"Tartarus",2,13,2,10,2,2,1,1,3,0,10,2,0,0,0,2,10,0,3,"standard","2022-06-04T00:00:00.000Z","[23167,293,2687,3522,2650]","[6740,22846,745,679,15738]","Breach,Sova,Jett,Astra,Chamber","Breach,Omen,Jett,Skye,Chamber",1588
65214,29223,"VCT Korea 2022 - Stage 2 Challengers - Group Stage","Fracture",1515,"World Game Star",7156,"Tartarus",1,13,4,9,3,2,1,1,9,3,4,1,0,0,0,1,4,3,9,"standard","2022-06-04T00:00:00.000Z","[293,2687,3522,23167,2650]","[679,22846,745,6740,15738]","Breach,Viper,Brimstone,Chamber,Neon","Breach,Brimstone,Jett,KAY/O,Chamber",1588
68482,30629,"VCT North America 2022 - Stage 2 Challengers - Group Stage","Ascent",1448,"Evil Geniuses",6426,"OpTic Gaming",1,13,11,4,8,1,0,1,4,8,9,3,1,0,1,3,9,8,4,"standard","2022-06-04T00:00:00.000Z","[2882,3842,4157,1023,11672]","[2841,398,3211,2716,2483]","Sova,Omen,KAY/O,Chamber,Fade","Breach,Omen,Yoru,Chamber,Fade",1588
68481,30629,"VCT North America 2022 - Stage 2 Challengers - Group Stage","Split",1448,"Evil Geniuses",6426,"OpTic Gaming",1,11,13,6,6,2,1,1,6,6,5,7,0,0,0,7,5,6,6,"standard","2022-06-04T00:00:00.000Z","[2882,4157,1023,11672,3842]","[2841,398,2483,2716,3211]","Breach,Raze,Cypher,Skye,Astra","Breach,Astra,KAY/O,Chamber,Neon",1588
68480,30629,"VCT North America 2022 - Stage 2 Challengers - Group Stage","Bind",1448,"Evil Geniuses",6426,"OpTic Gaming",2,13,8,7,5,2,1,1,6,3,7,5,0,0,0,5,7,3,6,"standard","2022-06-03T00:00:00.000Z","[4157,3842,11672,1023,2882]","[3211,2841,398,2483,2716]","Raze,Brimstone,Skye,Chamber,Fade","Raze,Viper,Brimstone,Skye,Chamber",1588
68479,30628,"VCT North America 2022 - Stage 2 Challengers - Group Stage","Haven",5201,"The Guard",603,"XSET",2,11,13,5,7,1,1,0,6,6,5,7,1,1,0,7,5,6,6,"standard","2022-06-03T00:00:00.000Z","[1091,11412,4141,2551,1804]","[494,3062,3582,3346,1802]","Breach,Sova,Killjoy,Jett,Astra","Breach,Omen,Jett,Skye,Chamber",1588
68478,30628,"VCT North America 2022 - Stage 2 Challengers - Group Stage","Icebox",5201,"The Guard",603,"XSET",1,6,13,3,9,1,0,1,3,9,3,4,1,0,1,4,3,9,3,"standard","2022-06-03T00:00:00.000Z","[11412,4141,1804,1091,2551]","[3582,3346,3062,494,1802]","Sova,Killjoy,Viper,Sage,Jett","Raze,Sova,Viper,KAY/O,Chamber",1588
68477,30628,"VCT North America 2022 - Stage 2 Challengers - Group Stage","Split",5201,"The Guard",603,"XSET",2,14,12,6,6,1,0,1,7,6,7,6,1,0,1,6,7,6,7,"standard","2022-06-03T00:00:00.000Z","[2551,4141,1091,11412,1804]","[3582,3062,3346,494,1802]","Raze,Viper,Sage,Skye,Astra","Raze,Viper,Skye,Astra,Chamber",1588
68500,30635,"VCT EMEA 2022 - Stage 2 Challengers - Group Stage","Split",4220,"Natus Vincere",224,"Team Liquid",1,14,16,6,6,1,1,0,7,8,7,8,1,1,0,8,7,8,7,"standard","2022-06-03T00:00:00.000Z","[491,999,2279,2983,3003]","[2571,1690,17788,10211,2056]","Breach,Raze,Cypher,Sage,Omen","Breach,Raze,Cypher,Omen,Astra",1588
68499,30635,"VCT EMEA 2022 - Stage 2 Challengers - Group Stage","Bind",4220,"Natus Vincere",224,"Team Liquid",1,13,11,7,5,0,0,0,7,5,6,6,2,1,1,6,6,5,7,"standard","2022-06-03T00:00:00.000Z","[2279,491,2983,999,3003]","[2571,1690,10211,17788,2056]","Viper,Omen,Skye,Chamber,Fade","Breach,Raze,Omen,Chamber,Fade",1588
68498,30635,"VCT EMEA 2022 - Stage 2 Challengers - Group Stage","Haven",4220,"Natus Vincere",224,"Team Liquid",2,11,13,5,7,2,1,1,6,6,5,7,0,0,0,7,5,6,6,"standard","2022-06-03T00:00:00.000Z","[2279,2983,491,999,3003]","[2571,1690,10211,17788,2056]","Breach,Raze,Omen,Chamber,Fade","Breach,Raze,Omen,Chamber,Fade",1588
68497,30634,"VCT EMEA 2022 - Stage 2 Challengers - Group Stage","Bind",2597,"Acend",194,"G2 Esports (Inactive)",2,13,11,5,7,1,1,0,8,4,5,7,1,1,0,7,5,4,8,"standard","2022-06-03T00:00:00.000Z","[691,1268,2391,87,732]","[1826,2377,2940,2594,2769]","Raze,Viper,Omen,Skye,Chamber","Raze,Viper,Sage,Skye,Astra",1588
68496,30634,"VCT EMEA 2022 - Stage 2 Challengers - Group Stage","Icebox",2597,"Acend",194,"G2 Esports (Inactive)",2,13,10,6,6,1,0,1,7,4,6,6,1,0,1,6,6,4,7,"standard","2022-06-03T00:00:00.000Z","[87,1268,691,2391,732]","[1826,2377,2769,2594,2940]","Sova,Viper,Sage,KAY/O,Chamber","Sova,Killjoy,Viper,Sage,Chamber",1588
68495,30634,"VCT EMEA 2022 - Stage 2 Challengers - Group Stage","Split",2597,"Acend",194,"G2 Esports (Inactive)",1,3,13,2,10,0,0,0,2,10,1,3,2,1,1,3,1,10,2,"standard","2022-06-03T00:00:00.000Z","[2391,1268,87,691,732]","[1826,2377,2594,2769,2940]","Raze,Cypher,Sage,Omen,Jett","Raze,Cypher,Sage,Omen,Chamber",1588
68247,30517,"VCT Korea 2022 - Stage 2 Challengers - Group Stage","Breeze",7156,"Tartarus",286,"DRX",2,9,13,4,8,2,1,1,5,5,4,8,0,0,0,8,4,5,5,"standard","2022-05-31T00:00:00.000Z","[679,22846,745,6740,15738]","[814,452,582,1550,1251]","Sova,Viper,Jett,KAY/O,Chamber","Sova,Viper,Skye,KAY/O,Chamber",1588
68246,30517,"VCT Korea 2022 - Stage 2 Challengers - Group Stage","Split",7156,"Tartarus",286,"DRX",1,9,13,5,7,2,1,1,5,7,4,6,0,0,0,6,4,7,5,"standard","2022-05-31T00:00:00.000Z","[6740,745,679,22846,15738]","[582,814,452,1251,1550]","Breach,Raze,Sage,Omen,Chamber","Breach,Sage,Omen,Chamber,Neon",1588
65210,29221,"VCT Korea 2022 - Stage 2 Challengers - Group Stage","Haven",1515,"World Game Star",6366,"Maru Gaming",2,6,13,2,10,0,0,0,4,3,2,10,2,1,1,10,2,3,4,"standard","2022-05-31T00:00:00.000Z","[2687,23167,3522,15724,293]","[6595,2762,8382,6719,4229]","Breach,Killjoy,Omen,Jett,Fade","Breach,Omen,Jett,Skye,Chamber",1588
65209,29221,"VCT Korea 2022 - Stage 2 Challengers - Group Stage","Breeze",1515,"World Game Star",6366,"Maru Gaming",2,9,13,6,6,2,1,1,3,7,6,6,0,0,0,6,6,7,3,"standard","2022-05-31T00:00:00.000Z","[3522,15724,2687,23167,293]","[6595,2762,8382,4229,6719]","Viper,Jett,KAY/O,Chamber,Fade","Sova,Viper,Jett,KAY/O,Chamber",1588
65208,29221,"VCT Korea 2022 - Stage 2 Challengers - Group Stage","Bind",1515,"World Game Star",6366,"Maru Gaming",1,13,2,10,2,1,0,1,10,2,3,0,1,0,1,0,3,2,10,"standard","2022-05-31T00:00:00.000Z","[293,23167,3522,2687,2650]","[6595,2762,4229,8382,6719]","Sage,Reyna,Omen,Skye,Neon","Breach,Brimstone,Chamber,Neon,Fade",1588
65206,29220,"VCT Korea 2022 - Stage 2 Challengers - Group Stage","Ascent",6406,"CNJ Esports",5373,"On Sla2ers",1,11,13,1,11,1,0,1,1,11,10,2,1,0,1,2,10,11,1,"standard","2022-05-30T00:00:00.000Z","[225,6692,1008,2306,6738]","[2151,1075,2009,2904,1199]","Raze,Omen,KAY/O,Chamber,Fade","Killjoy,Yoru,Astra,KAY/O,Fade",1588
65205,29220,"VCT Korea 2022 - Stage 2 Challengers - Group Stage","Breeze",6406,"CNJ Esports",5373,"On Sla2ers",2,2,13,2,10,0,0,0,0,3,2,10,2,1,1,10,2,3,0,"standard","2022-05-30T00:00:00.000Z","[6738,6692,1008,225,2306]","[2151,1199,2009,1075,2904]","Sova,Viper,Skye,KAY/O,Chamber","Cypher,Sova,Viper,Yoru,KAY/O",1588
65203,29219,"VCT Korea 2022 - Stage 2 Challengers - Group Stage","Bind",1267,"Spear Gaming",997,"DAMWON Gaming",2,5,13,1,11,1,1,0,4,2,1,11,1,1,0,11,1,2,4,"standard","2022-05-30T00:00:00.000Z","[8076,15737,18839,18840,6600]","[315,4811,2240,2368,6546]","Breach,Raze,Brimstone,Skye,Chamber","Breach,Raze,Brimstone,Skye,Chamber",1588
65202,29219,"VCT Korea 2022 - Stage 2 Challengers - Group Stage","Ascent",1267,"Spear Gaming",997,"DAMWON Gaming",1,7,13,5,7,1,0,1,5,7,2,6,1,0,1,6,2,7,5,"standard","2022-05-30T00:00:00.000Z","[6600,18839,8076,15737,18840]","[315,2240,4811,6546,2368]","Sage,Omen,KAY/O,Chamber,Fade","Sage,Omen,Jett,KAY/O,Fade",1588
66548,29785,"VCT Brazil 2022 - Stage 2 Challengers 1 - Group Stage","Split",600,"Keyd Stars",319,"Liberty",2,13,6,10,2,1,0,1,3,4,10,2,1,0,1,2,10,4,3,"standard","2022-05-30T00:00:00.000Z","[957,81,277,4771,5288]","[4745,986,2054,2927,23522]","Breach,Raze,Sage,Omen,Chamber","Raze,Sage,Omen,Skye,Chamber",1588
66547,29785,"VCT Brazil 2022 - Stage 2 Challengers 1 - Group Stage","Bind",600,"Keyd Stars",319,"Liberty",2,13,5,7,5,1,1,0,6,0,7,5,1,1,0,5,7,0,6,"standard","2022-05-30T00:00:00.000Z","[81,277,4771,957,5288]","[986,4745,2054,2927,23522]","Raze,Viper,Brimstone,Skye,Chamber","Breach,Raze,Brimstone,Skye,Fade",1588
66546,29785,"VCT Brazil 2022 - Stage 2 Challengers 1 - Group Stage","Haven",600,"Keyd Stars",319,"Liberty",1,10,13,3,9,1,0,1,3,9,7,4,1,0,1,4,7,9,3,"standard","2022-05-29T00:00:00.000Z","[957,81,4771,277,5288]","[986,4745,2054,2927,23522]","Breach,Raze,Omen,Skye,Chamber","Breach,Raze,Omen,Skye,Chamber",1588
67564,30261,"VCT LATAM South 2022 - Stage 2 Challengers - Group Stage","Ascent",738,"Leviatán",976,"KRÜ Esports",1,9,13,6,6,2,1,1,6,6,3,7,0,0,0,7,3,6,6,"standard","2022-05-29T00:00:00.000Z","[3531,3421,3555,3532,6414]","[1725,4712,3535,2532,4710]","Sova,Omen,KAY/O,Chamber,Neon","Raze,Sova,Omen,Chamber,Fade",1588
66759,29865,"VCT North America 2022 - Stage 2 Challengers - Group Stage","Breeze",978,"Ghost Gaming",116,"NRG Esports",2,13,5,9,3,1,0,1,4,2,9,3,1,0,1,3,9,2,4,"standard","2022-05-29T00:00:00.000Z","[1468,3074,3016,1780,1578]","[1597,1232,165,10253,1763]","Sova,Viper,Jett,KAY/O,Chamber","Sova,Viper,Omen,Skye,Chamber",1588
67563,30261,"VCT LATAM South 2022 - Stage 2 Challengers - Group Stage","Breeze",738,"Leviatán",976,"KRÜ Esports",1,8,13,6,6,1,0,1,6,6,2,7,1,0,1,7,2,6,6,"standard","2022-05-29T00:00:00.000Z","[3531,3421,3555,3532,6414]","[4712,3535,4710,2532,1725]","Sova,Viper,KAY/O,Chamber,Neon","Sova,Viper,KAY/O,Chamber,Neon",1588
66545,29784,"VCT Brazil 2022 - Stage 2 Challengers 1 - Group Stage","Haven",5747,"TBK Esports",5750,"Ninjas in Pyjamas",2,10,13,6,6,2,1,1,4,7,6,6,0,0,0,6,6,7,4,"standard","2022-05-29T00:00:00.000Z","[2366,2457,9831,1506,5580]","[2901,16804,762,3203,2195]","Breach,Killjoy,Omen,Jett,Skye","Omen,Skye,KAY/O,Chamber,Neon",1588
66758,29865,"VCT North America 2022 - Stage 2 Challengers - Group Stage","Haven",978,"Ghost Gaming",116,"NRG Esports",1,13,6,8,4,2,1,1,8,4,5,2,0,0,0,2,5,4,8,"standard","2022-05-29T00:00:00.000Z","[1468,1780,3074,3016,1578]","[1597,1232,165,1763,10253]","Breach,Raze,Astra,Chamber,Fade","Breach,Omen,Yoru,Chamber,Fade",1588
67562,30261,"VCT LATAM South 2022 - Stage 2 Challengers - Group Stage","Haven",738,"Leviatán",976,"KRÜ Esports",2,14,12,8,4,2,1,1,5,8,9,4,0,0,0,4,9,8,5,"standard","2022-05-29T00:00:00.000Z","[3531,3421,3555,3532,6414]","[4712,3535,2532,1725,4710]","Breach,Omen,Skye,Chamber,Neon","Breach,Omen,Chamber,Neon,Fade",1588
66544,29784,"VCT Brazil 2022 - Stage 2 Challengers 1 - Group Stage","Ascent",5747,"TBK Esports",5750,"Ninjas in Pyjamas",2,14,12,4,8,2,1,1,9,4,5,8,0,0,0,8,5,4,9,"standard","2022-05-29T00:00:00.000Z","[5580,2457,2366,9831,1506]","[762,2901,3203,16804,2195]","Sova,Killjoy,Sage,Omen,Jett","Killjoy,Omen,Jett,KAY/O,Fade",1588
66762,29866,"VCT North America 2022 - Stage 2 Challengers - Group Stage","Haven",617,"FaZe Clan",141,"Cloud9",1,13,8,6,6,2,1,1,6,6,7,2,0,0,0,2,7,6,6,"standard","2022-05-29T00:00:00.000Z","[1689,1994,1990,789,369]","[2213,13591,3773,3599,4639]","Breach,Omen,Skye,Chamber,Neon","Breach,Raze,Omen,Chamber,Fade",1588
66543,29784,"VCT Brazil 2022 - Stage 2 Challengers 1 - Group Stage","Split",5747,"TBK Esports",5750,"Ninjas in Pyjamas",1,7,13,6,6,0,0,0,6,6,1,7,2,1,1,7,1,6,6,"standard","2022-05-29T00:00:00.000Z","[2366,2457,5580,9831,1506]","[3203,762,16804,2901,2195]","Raze,Viper,Skye,Astra,Chamber","Raze,Cypher,Sage,Omen,Jett",1588
66761,29866,"VCT North America 2022 - Stage 2 Challengers - Group Stage","Fracture",617,"FaZe Clan",141,"Cloud9",2,13,5,8,4,1,1,0,5,1,8,4,1,1,0,4,8,1,5,"standard","2022-05-29T00:00:00.000Z","[1689,1994,1990,789,369]","[4639,13591,3773,2213,3599]","Breach,Brimstone,KAY/O,Chamber,Neon","Breach,Raze,Brimstone,Sage,Chamber",1588
67560,30260,"VCT LATAM South 2022 - Stage 2 Challengers - Group Stage","Ascent",5106,"PAMPAS",1503,"Movistar Optix",1,8,13,6,6,0,0,0,6,6,2,7,2,1,1,7,2,6,6,"standard","2022-05-29T00:00:00.000Z","[3718,3538,5709,4601,32]","[3409,1579,14764,3411,14762]","Killjoy,Omen,Jett,KAY/O,Fade","Sova,Killjoy,Jett,Astra,KAY/O",1588
67559,30260,"VCT LATAM South 2022 - Stage 2 Challengers - Group Stage","Haven",5106,"PAMPAS",1503,"Movistar Optix",2,12,14,8,4,0,0,0,4,9,8,5,2,1,1,5,8,9,4,"standard","2022-05-29T00:00:00.000Z","[4601,5709,3718,32,3538]","[14762,1579,3409,14764,3411]","Breach,Raze,Cypher,Sova,Omen","Breach,Cypher,Sova,Jett,Astra",1588
67076,30094,"VCT EMEA 2022 - Stage 2 Challengers - Group Stage","Fracture",5439,"FOKUS",17,"FunPlus Phoenix",1,1,13,1,11,0,0,0,1,11,0,2,2,1,1,2,0,11,1,"standard","2022-05-29T00:00:00.000Z","[3150,7669,5687,4227,20802]","[2225,2335,1256,3043,2359]","Breach,Raze,Cypher,Brimstone,Neon","Sage,Omen,KAY/O,Chamber,Fade",1588
67075,30094,"VCT EMEA 2022 - Stage 2 Challengers - Group Stage","Breeze",5439,"FOKUS",17,"FunPlus Phoenix",1,11,13,6,6,2,1,1,6,6,5,7,0,0,0,7,5,6,6,"standard","2022-05-29T00:00:00.000Z","[5687,3150,4227,20802,7669]","[2225,2359,2335,3043,1256]","Cypher,Sova,Viper,Jett,KAY/O","Cypher,Sova,Viper,Jett,KAY/O",1588
67073,30093,"VCT EMEA 2022 - Stage 2 Challengers - Group Stage","Breeze",520,"BBL Esports",6656,"M3 Champions",1,5,13,3,9,1,0,1,3,9,2,4,1,0,1,4,2,9,3,"standard","2022-05-29T00:00:00.000Z","[2864,3152,1749,9643,1852]","[1964,1081,3135,2528,274]","Sova,Viper,KAY/O,Chamber,Neon","Sova,Viper,Jett,Skye,Chamber",1588
67072,30093,"VCT EMEA 2022 - Stage 2 Challengers - Group Stage","Fracture",520,"BBL Esports",6656,"M3 Champions",1,8,13,5,7,0,0,0,5,7,3,6,2,1,1,6,3,7,5,"standard","2022-05-29T00:00:00.000Z","[1749,3152,2864,1852,9643]","[1964,3135,1081,274,2528]","Breach,Brimstone,Sage,Chamber,Neon","Breach,Raze,Cypher,Brimstone,Sage",1588
65200,29218,"VCT Korea 2022 - Stage 2 Challengers - Group Stage","Fracture",7156,"Tartarus",6366,"Maru Gaming",1,6,13,4,8,0,0,0,4,8,2,5,2,1,1,5,2,8,4,"standard","2022-05-29T00:00:00.000Z","[679,22846,745,6740,15738]","[6595,2762,6719,4229,8382]","Breach,Brimstone,Jett,KAY/O,Chamber","Breach,Brimstone,KAY/O,Chamber,Neon",1588
65199,29218,"VCT Korea 2022 - Stage 2 Challengers - Group Stage","Haven",7156,"Tartarus",6366,"Maru Gaming",2,11,13,6,6,0,0,0,5,7,6,6,2,1,1,6,6,7,5,"standard","2022-05-29T00:00:00.000Z","[6740,22846,745,679,15738]","[6595,2762,8382,6719,4229]","Breach,Omen,Jett,Skye,Chamber","Breach,Omen,Jett,Skye,Chamber",1588
65197,29217,"VCT Korea 2022 - Stage 2 Challengers - Group Stage","Breeze",1515,"World Game Star",286,"DRX",2,5,13,2,10,0,0,0,3,3,2,10,2,1,1,10,2,3,3,"standard","2022-05-29T00:00:00.000Z","[3522,15724,2687,23167,293]","[814,452,582,1550,1251]","Viper,Jett,KAY/O,Chamber,Fade","Sova,Viper,Skye,KAY/O,Chamber",1588
65196,29217,"VCT Korea 2022 - Stage 2 Challengers - Group Stage","Bind",1515,"World Game Star",286,"DRX",2,6,13,5,7,0,0,0,1,6,5,7,2,1,1,7,5,6,1,"standard","2022-05-29T00:00:00.000Z","[293,23167,3522,2687,2650]","[582,452,1251,1550,814]","Sage,Reyna,Omen,Skye,Neon","Breach,Brimstone,Chamber,Neon,Fade",1588
66541,29783,"VCT Brazil 2022 - Stage 2 Challengers 1 - Group Stage","Split",1264,"FURIA",5748,"Los Grandes",2,13,9,9,3,1,0,1,4,6,9,3,1,0,1,3,9,6,4,"standard","2022-05-29T00:00:00.000Z","[6039,18192,2749,2423,2752]","[6231,4770,2103,669,2420]","Raze,Sage,Omen,Chamber,Fade","Breach,Raze,Astra,Chamber,Fade",1588
66540,29783,"VCT Brazil 2022 - Stage 2 Challengers 1 - Group Stage","Breeze",1264,"FURIA",5748,"Los Grandes",1,13,6,7,5,1,0,1,7,5,6,1,1,0,1,1,6,5,7,"standard","2022-05-28T00:00:00.000Z","[18192,2749,6039,2752,2423]","[2103,4770,6231,2420,669]","Sova,Viper,Jett,KAY/O,Chamber","Cypher,Sova,Viper,KAY/O,Chamber",1588
66754,29863,"VCT North America 2022 - Stage 2 Challengers - Group Stage","Bind",305,"100 Thieves",603,"XSET",1,13,9,5,7,1,0,1,5,7,8,2,1,0,1,2,8,7,5,"standard","2022-05-28T00:00:00.000Z","[2354,122,1012,269,763]","[494,3582,3346,3062,1802]","Raze,Viper,Brimstone,Sage,Skye","Breach,Raze,Sova,Astra,Chamber",1588
66553,29787,"VCT LATAM South 2022 - Stage 2 Challengers - Group Stage","Icebox",7014,"SunXet Club",738,"Leviatán",1,6,13,5,7,1,1,0,5,7,1,6,1,1,0,6,1,7,5,"standard","2022-05-28T00:00:00.000Z","[3504,5907,3458,3503,3719]","[3531,6414,3421,3555,3532]","Sova,Viper,Sage,KAY/O,Chamber","Sova,Viper,Sage,KAY/O,Chamber",1588
66752,29863,"VCT North America 2022 - Stage 2 Challengers - Group Stage","Breeze",305,"100 Thieves",603,"XSET",2,13,4,9,3,2,1,1,4,1,9,3,0,0,0,3,9,1,4,"standard","2022-05-28T00:00:00.000Z","[122,269,1012,2354,763]","[3346,3062,3582,494,1802]","Cypher,Sova,Viper,Jett,KAY/O","Sova,Viper,Jett,KAY/O,Chamber",1588
66538,29782,"VCT Brazil 2022 - Stage 2 Challengers 1 - Group Stage","Fracture",1380,"Stars Horizon",580,"Gamelanders Blue",2,15,13,4,8,1,1,0,10,4,5,9,1,1,0,9,5,4,10,"standard","2022-05-28T00:00:00.000Z","[242,20594,177,59,9801]","[739,1113,1427,6038,4747]","Breach,Raze,Cypher,Brimstone,Chamber","Breach,Raze,Brimstone,Chamber,Fade",1588
66552,29787,"VCT LATAM South 2022 - Stage 2 Challengers - Group Stage","Breeze",7014,"SunXet Club",738,"Leviatán",2,3,13,3,9,0,0,0,0,4,3,9,2,1,1,9,3,4,0,"standard","2022-05-28T00:00:00.000Z","[3504,5907,3458,3503,3719]","[3531,3421,3555,3532,6414]","Sova,Viper,Astra,KAY/O,Chamber","Sova,Viper,KAY/O,Chamber,Neon",1588
66756,29864,"VCT North America 2022 - Stage 2 Challengers - Group Stage","Bind",388,"Sentinels",6426,"OpTic Gaming",1,8,13,2,10,2,1,1,2,10,6,3,0,0,0,3,6,10,2,"standard","2022-05-28T00:00:00.000Z","[370,724,555,893,1249]","[3211,2841,398,2483,2716]","Sova,Viper,Omen,Jett,Skye","Raze,Viper,Brimstone,Skye,Chamber",1588
66537,29782,"VCT Brazil 2022 - Stage 2 Challengers 1 - Group Stage","Ascent",1380,"Stars Horizon",580,"Gamelanders Blue",1,13,11,8,4,0,0,0,8,4,5,7,2,1,1,7,5,4,8,"standard","2022-05-28T00:00:00.000Z","[242,59,20594,177,9801]","[4747,1427,739,6038,1113]","Sova,Omen,Jett,KAY/O,Chamber","Sova,Astra,KAY/O,Chamber,Fade",1588
66755,29864,"VCT North America 2022 - Stage 2 Challengers - Group Stage","Fracture",388,"Sentinels",6426,"OpTic Gaming",2,5,13,2,10,1,1,0,3,3,2,10,1,1,0,10,2,3,3,"standard","2022-05-28T00:00:00.000Z","[370,555,724,893,1249]","[2841,398,2483,2716,3211]","Breach,Brimstone,Sage,Chamber,Neon","Breach,Brimstone,KAY/O,Chamber,Neon",1588
66550,29786,"VCT LATAM South 2022 - Stage 2 Challengers - Group Stage","Split",5106,"PAMPAS",683,"9z Team",1,9,13,4,8,1,0,1,4,8,5,5,1,0,1,5,5,8,4,"standard","2022-05-28T00:00:00.000Z","[32,5709,3718,4601,3538]","[855,3506,9905,1376,3510]","Breach,Raze,Cypher,Sage,Omen","Raze,Cypher,Sage,Omen,Skye",1588
66549,29786,"VCT LATAM South 2022 - Stage 2 Challengers - Group Stage","Haven",5106,"PAMPAS",683,"9z Team",2,11,13,7,5,1,0,1,4,8,7,5,1,0,1,5,7,8,4,"standard","2022-05-28T00:00:00.000Z","[4601,5709,3718,32,3538]","[9905,855,1376,3510,3506]","Breach,Raze,Cypher,Sova,Omen","Breach,Raze,Omen,Chamber,Fade",1588
67070,30092,"VCT EMEA 2022 - Stage 2 Challengers - Group Stage","Icebox",2597,"Acend",1625,"FNATIC",1,8,13,6,6,1,1,0,6,6,2,7,1,1,0,7,2,6,6,"standard","2022-05-28T00:00:00.000Z","[87,1268,732,2391,691]","[718,14543,2011,76,2937]","Sova,Viper,Reyna,KAY/O,Chamber","Sova,Killjoy,Viper,Sage,Chamber",1588
67069,30092,"VCT EMEA 2022 - Stage 2 Challengers - Group Stage","Ascent",2597,"Acend",1625,"FNATIC",1,4,13,4,8,1,1,0,4,8,0,5,1,1,0,5,0,8,4,"standard","2022-05-28T00:00:00.000Z","[87,1268,691,732,2391]","[14543,2011,76,2937,718]","Sova,Killjoy,Omen,Jett,KAY/O","Raze,Omen,KAY/O,Chamber,Fade",1588
67068,30091,"VCT EMEA 2022 - Stage 2 Challengers - Group Stage","Haven",329,"BIG",4220,"Natus Vincere",1,7,13,4,8,1,0,1,4,8,3,5,1,0,1,5,3,8,4,"standard","2022-05-28T00:00:00.000Z","[1828,360,2326,1538,819]","[2279,491,999,2983,3003]","Breach,Killjoy,Omen,Jett,Fade","Breach,Omen,Chamber,Neon,Fade",1588
67067,30091,"VCT EMEA 2022 - Stage 2 Challengers - Group Stage","Ascent",329,"BIG",4220,"Natus Vincere",1,9,13,5,7,0,0,0,5,7,4,6,2,1,1,6,4,7,5,"standard","2022-05-28T00:00:00.000Z","[360,1828,2326,1538,819]","[2983,2279,491,999,3003]","Sova,Killjoy,Omen,Jett,KAY/O","Sova,Killjoy,Omen,Jett,KAY/O",1588
67066,30091,"VCT EMEA 2022 - Stage 2 Challengers - Group Stage","Bind",329,"BIG",4220,"Natus Vincere",2,13,9,9,3,1,1,0,4,6,9,3,1,1,0,3,9,6,4,"standard","2022-05-28T00:00:00.000Z","[1538,2326,360,1828,819]","[2983,2279,491,3003,999]","Raze,Brimstone,Skye,Chamber,Fade","Raze,Viper,Omen,Skye,Chamber",1588
65194,29216,"VCT Korea 2022 - Stage 2 Challengers - Group Stage","Split",6406,"CNJ Esports",997,"DAMWON Gaming",2,10,13,5,7,0,0,0,5,6,5,7,2,1,1,7,5,6,5,"standard","2022-05-28T00:00:00.000Z","[1008,6738,6692,225,2306]","[315,2368,2240,4811,6546]","Raze,Sage,Omen,KAY/O,Chamber","Breach,Sage,Omen,Jett,Chamber",1588
65193,29216,"VCT Korea 2022 - Stage 2 Challengers - Group Stage","Breeze",6406,"CNJ Esports",997,"DAMWON Gaming",2,10,13,5,7,0,0,0,5,6,5,7,2,1,1,7,5,6,5,"standard","2022-05-28T00:00:00.000Z","[6738,6692,1008,225,2306]","[2368,315,4811,6546,2240]","Sova,Viper,Skye,KAY/O,Chamber","Sova,Viper,Jett,KAY/O,Chamber",1588
65191,29215,"VCT Korea 2022 - Stage 2 Challengers - Group Stage","Ascent",5373,"On Sla2ers",1267,"Spear Gaming",2,13,4,9,3,1,0,1,4,1,9,3,1,0,1,3,9,1,4,"standard","2022-05-28T00:00:00.000Z","[2151,1075,2009,2904,1199]","[6600,18839,15737,8076,18840]","Killjoy,Yoru,Astra,KAY/O,Fade","Killjoy,Omen,Jett,KAY/O,Fade",1588
65190,29215,"VCT Korea 2022 - Stage 2 Challengers - Group Stage","Breeze",5373,"On Sla2ers",1267,"Spear Gaming",2,13,10,7,5,1,0,1,6,5,7,5,1,0,1,5,7,5,6,"standard","2022-05-28T00:00:00.000Z","[2151,1199,2009,1075,2904]","[18840,8076,15737,18839,6600]","Cypher,Sova,Viper,Yoru,KAY/O","Sova,Viper,Jett,KAY/O,Chamber",1588
66750,29862,"VCT North America 2022 - Stage 2 Challengers - Group Stage","Bind",279,"Luminosity Gaming",1448,"Evil Geniuses",1,2,13,2,10,0,0,0,2,10,0,3,2,1,1,3,0,10,2,"standard","2022-05-27T00:00:00.000Z","[1801,3345,1522,2489,905]","[4157,3842,11672,1023,2882]","Raze,Viper,Brimstone,Skye,Chamber","Raze,Brimstone,Skye,Chamber,Fade",1588
66749,29862,"VCT North America 2022 - Stage 2 Challengers - Group Stage","Icebox",279,"Luminosity Gaming",1448,"Evil Geniuses",2,7,13,2,10,0,0,0,5,3,2,10,2,1,1,10,2,3,5,"standard","2022-05-27T00:00:00.000Z","[2489,1522,3345,1801,905]","[2882,3842,11672,4157,1023]","Sova,Viper,Sage,Reyna,Jett","Sova,Viper,Sage,Jett,Chamber",1588
66747,29861,"VCT North America 2022 - Stage 2 Challengers - Group Stage","Icebox",5201,"The Guard",278,"TSM",1,13,7,8,4,2,1,1,8,4,5,3,0,0,0,3,5,4,8,"standard","2022-05-27T00:00:00.000Z","[11412,4141,1804,1091,2551]","[5305,2479,4239,2098,1217]","Sova,Killjoy,Viper,Sage,Jett","Sova,Viper,Sage,Omen,Chamber",1588
66746,29861,"VCT North America 2022 - Stage 2 Challengers - Group Stage","Haven",5201,"The Guard",278,"TSM",2,13,10,5,7,1,1,0,8,3,5,7,1,1,0,7,5,3,8,"standard","2022-05-27T00:00:00.000Z","[1091,11412,4141,2551,1804]","[5305,2098,2479,1217,4239]","Breach,Sova,Killjoy,Jett,Astra","Breach,Omen,Skye,Chamber,Neon",1588
67065,30090,"VCT EMEA 2022 - Stage 2 Challengers - Group Stage","Fracture",7050,"OG LDN UTD",194,"G2 Esports (Inactive)",2,13,11,5,7,0,0,0,8,4,5,7,2,1,1,7,5,4,8,"standard","2022-05-27T00:00:00.000Z","[1894,2561,2199,426,2305]","[2377,2769,2940,1826,2594]","Breach,Raze,Cypher,Brimstone,Sage","Breach,Brimstone,KAY/O,Chamber,Neon",1588
67064,30090,"VCT EMEA 2022 - Stage 2 Challengers - Group Stage","Breeze",7050,"OG LDN UTD",194,"G2 Esports (Inactive)",1,10,13,5,7,0,0,0,5,7,5,6,2,1,1,6,5,7,5,"standard","2022-05-27T00:00:00.000Z","[2199,426,2305,2561,1894]","[2377,2769,2594,2940,1826]","Cypher,Sova,Viper,KAY/O,Chamber","Sova,Viper,Jett,Skye,Chamber",1588
67063,30090,"VCT EMEA 2022 - Stage 2 Challengers - Group Stage","Ascent",7050,"OG LDN UTD",194,"G2 Esports (Inactive)",1,13,9,7,5,2,1,1,7,5,6,4,0,0,0,4,6,5,7,"standard","2022-05-27T00:00:00.000Z","[2199,2561,2305,1894,426]","[2377,2769,2594,2940,1826]","Cypher,Sova,Omen,Jett,Fade","Killjoy,Omen,Jett,KAY/O,Fade",1588
67062,30089,"VCT EMEA 2022 - Stage 2 Challengers - Group Stage","Fracture",224,"Team Liquid",386,"Guild Esports",2,4,13,2,10,1,1,0,2,3,2,10,1,1,0,10,2,3,2,"standard","2022-05-27T00:00:00.000Z","[1403,1690,17788,10211,2056]","[449,966,2321,2318,1834]","Breach,Raze,Cypher,Skye,Astra","Breach,Raze,Brimstone,Sage,Chamber",1588
67061,30089,"VCT EMEA 2022 - Stage 2 Challengers - Group Stage","Icebox",224,"Team Liquid",386,"Guild Esports",2,13,6,9,3,1,0,1,4,3,9,3,1,0,1,3,9,3,4,"standard","2022-05-27T00:00:00.000Z","[1690,17788,1403,10211,2056]","[966,449,1834,2321,2318]","Raze,Viper,Sage,Omen,Fade","Raze,Sova,Killjoy,Viper,Sage",1588
67060,30089,"VCT EMEA 2022 - Stage 2 Challengers - Group Stage","Split",224,"Team Liquid",386,"Guild Esports",2,3,13,2,10,0,0,0,1,3,2,10,2,1,1,10,2,3,1,"standard","2022-05-27T00:00:00.000Z","[1403,1690,17788,10211,2056]","[449,966,1834,2318,2321]","Breach,Raze,Cypher,Omen,Astra","Breach,Raze,Cypher,Sage,Omen",1588
65189,29214,"VCT Korea 2022 - Stage 2 Challengers - Group Stage","Ascent",1267,"Spear Gaming",1515,"World Game Star",1,13,4,8,4,2,1,1,8,4,5,0,0,0,0,0,5,4,8,"standard","2022-05-24T00:00:00.000Z","[6600,18839,15737,8076,18840]","[2650,23167,3522,15724,293]","Killjoy,Omen,Jett,KAY/O,Fade","Raze,Reyna,Omen,KAY/O,Fade",1588
65188,29214,"VCT Korea 2022 - Stage 2 Challengers - Group Stage","Haven",1267,"Spear Gaming",1515,"World Game Star",1,13,10,5,7,1,0,1,5,7,8,3,1,0,1,3,8,7,5,"standard","2022-05-24T00:00:00.000Z","[8076,18840,6600,18839,15737]","[2687,2650,23167,3522,293]","Breach,Sova,Killjoy,Omen,Jett","Breach,Raze,Reyna,Omen,Fade",1588
65187,29214,"VCT Korea 2022 - Stage 2 Challengers - Group Stage","Bind",1267,"Spear Gaming",1515,"World Game Star",1,3,13,3,9,0,0,0,3,9,0,4,2,1,1,4,0,9,3,"standard","2022-05-24T00:00:00.000Z","[8076,15737,18839,18840,6600]","[293,23167,3522,2687,2650]","Breach,Raze,Brimstone,Skye,Chamber","Sage,Reyna,Omen,Skye,Neon",1588
65186,29213,"VCT Korea 2022 - Stage 2 Challengers - Group Stage","Split",7156,"Tartarus",6406,"CNJ Esports",2,13,8,8,4,2,1,1,5,4,8,4,0,0,0,4,8,4,5,"standard","2022-05-24T00:00:00.000Z","[6740,745,679,22846,15738]","[225,6738,6692,1008,2306]","Breach,Raze,Sage,Omen,Chamber","Raze,Sage,Omen,KAY/O,Chamber",1588
65185,29213,"VCT Korea 2022 - Stage 2 Challengers - Group Stage","Icebox",7156,"Tartarus",6406,"CNJ Esports",2,6,13,6,6,0,0,0,0,7,6,6,2,1,1,6,6,7,0,"standard","2022-05-24T00:00:00.000Z","[22846,745,6740,15738,679]","[6738,6692,2306,225,1008]","Viper,Jett,KAY/O,Chamber,Fade","Sova,Viper,Reyna,Chamber,Fade",1588
65184,29213,"VCT Korea 2022 - Stage 2 Challengers - Group Stage","Fracture",7156,"Tartarus",6406,"CNJ Esports",2,13,5,10,2,1,0,1,3,3,10,2,1,0,1,2,10,3,3,"standard","2022-05-24T00:00:00.000Z","[679,22846,745,6740,15738]","[6738,225,6692,1008,2306]","Breach,Brimstone,Jett,KAY/O,Chamber","Breach,Raze,Brimstone,KAY/O,Chamber",1588
65182,29212,"VCT Korea 2022 - Stage 2 Challengers - Group Stage","Ascent",5373,"On Sla2ers",286,"DRX",2,6,13,3,9,0,0,0,3,4,3,9,2,1,1,9,3,4,3,"standard","2022-05-23T00:00:00.000Z","[2151,1075,2009,2904,1199]","[814,452,1550,1251,582]","Killjoy,Yoru,Astra,KAY/O,Fade","Sova,Astra,KAY/O,Chamber,Fade",1588
65181,29212,"VCT Korea 2022 - Stage 2 Challengers - Group Stage","Breeze",5373,"On Sla2ers",286,"DRX",2,8,13,1,11,1,1,0,7,2,1,11,1,1,0,11,1,2,7,"standard","2022-05-23T00:00:00.000Z","[2151,1199,2009,1075,2904]","[814,452,582,1550,1251]","Cypher,Sova,Viper,Yoru,KAY/O","Sova,Viper,Skye,KAY/O,Chamber",1588
65180,29211,"VCT Korea 2022 - Stage 2 Challengers - Group Stage","Haven",6366,"Maru Gaming",997,"DAMWON Gaming",1,11,13,7,5,1,1,0,7,5,4,8,1,1,0,8,4,5,7,"standard","2022-05-23T00:00:00.000Z","[6595,4229,2762,8382,6719]","[315,2368,4811,2240,6546]","Breach,Sage,Omen,Jett,Skye","Breach,Sova,Jett,Astra,Chamber",1588
65179,29211,"VCT Korea 2022 - Stage 2 Challengers - Group Stage","Fracture",6366,"Maru Gaming",997,"DAMWON Gaming",2,12,14,5,7,1,1,0,7,6,5,8,1,1,0,8,5,6,7,"standard","2022-05-23T00:00:00.000Z","[6595,2762,6719,4229,8382]","[315,4811,2240,2368,6546]","Breach,Brimstone,KAY/O,Chamber,Neon","Breach,Raze,Astra,KAY/O,Chamber",1588
65178,29211,"VCT Korea 2022 - Stage 2 Challengers - Group Stage","Breeze",6366,"Maru Gaming",997,"DAMWON Gaming",2,13,11,9,3,1,0,1,4,8,9,3,1,0,1,3,9,8,4,"standard","2022-05-23T00:00:00.000Z","[6595,2762,8382,4229,6719]","[2368,315,4811,6546,2240]","Sova,Viper,Jett,KAY/O,Chamber","Sova,Viper,Jett,KAY/O,Chamber",1588
65624,29390,"VCT North America 2022 - Stage 2 Challengers - Group Stage","Split",603,"XSET",116,"NRG Esports",1,13,9,7,5,0,0,0,7,5,6,4,2,1,1,4,6,5,7,"standard","2022-05-23T00:00:00.000Z","[3346,3582,3062,494,1802]","[165,1232,10253,1763,1597]","Breach,Raze,Sage,Astra,Chamber","Raze,Omen,KAY/O,Chamber,Fade",1588
65615,29387,"VCT Brazil 2022 - Stage 2 Challengers 1 - Group Stage","Breeze",1264,"FURIA",1380,"Stars Horizon",1,13,3,9,3,1,0,1,9,3,4,0,1,0,1,0,4,3,9,"standard","2022-05-22T00:00:00.000Z","[18192,2749,6039,2752,2423]","[177,242,59,9801,20594]","Sova,Viper,Jett,KAY/O,Chamber","Cypher,Sova,Viper,KAY/O,Neon",1588
65623,29390,"VCT North America 2022 - Stage 2 Challengers - Group Stage","Bind",603,"XSET",116,"NRG Esports",2,13,8,6,6,1,1,0,7,2,6,6,1,1,0,6,6,2,7,"standard","2022-05-22T00:00:00.000Z","[494,3582,3346,3062,1802]","[165,1232,10253,1763,1597]","Breach,Raze,Sova,Astra,Chamber","Raze,Brimstone,Skye,Chamber,Fade",1588
65614,29387,"VCT Brazil 2022 - Stage 2 Challengers 1 - Group Stage","Fracture",1264,"FURIA",1380,"Stars Horizon",1,13,5,9,3,0,0,0,9,3,4,2,2,1,1,2,4,3,9,"standard","2022-05-22T00:00:00.000Z","[18192,6039,2752,2749,2423]","[242,20594,177,59,9801]","Breach,Raze,Viper,Brimstone,Chamber","Breach,Raze,Cypher,Brimstone,Chamber",1588
66472,29760,"VCT LATAM South 2022 - Stage 2 Challengers - Group Stage","Ascent",683,"9z Team",976,"KRÜ Esports",1,2,13,2,10,0,0,0,2,10,0,3,2,1,1,3,0,10,2,"standard","2022-05-22T00:00:00.000Z","[9905,855,1376,3510,3506]","[1725,4712,3535,2532,4710]","Sova,Sage,Omen,KAY/O,Chamber","Raze,Sova,Omen,Chamber,Fade",1588
65606,29384,"VCT Brazil 2022 - Stage 2 Challengers 1 - Group Stage","Ascent",5748,"Los Grandes",6344,"LOUD",2,3,13,1,11,1,1,0,2,2,1,11,1,1,0,11,1,2,2,"standard","2022-05-22T00:00:00.000Z","[6231,669,2103,4770,2420]","[2294,4746,6037,4748,2895]","Killjoy,Jett,Astra,KAY/O,Fade","Sova,Killjoy,Omen,Jett,KAY/O",1588
65634,29393,"VCT North America 2022 - Stage 2 Challengers - Group Stage","Haven",6426,"OpTic Gaming",141,"Cloud9",1,13,10,6,6,0,0,0,6,6,7,4,2,1,1,4,7,6,6,"standard","2022-05-22T00:00:00.000Z","[2841,3211,398,2716,2483]","[4639,3599,3773,13591,2213]","Breach,Raze,Astra,Chamber,Fade","Breach,Raze,Omen,Skye,Chamber",1588
65633,29393,"VCT North America 2022 - Stage 2 Challengers - Group Stage","Ascent",6426,"OpTic Gaming",141,"Cloud9",1,13,5,9,3,2,1,1,9,3,4,2,0,0,0,2,4,3,9,"standard","2022-05-22T00:00:00.000Z","[2841,398,3211,2716,2483]","[4639,3773,3599,13591,2213]","Breach,Omen,Yoru,Chamber,Fade","Sova,Omen,Jett,KAY/O,Chamber",1588
66471,29760,"VCT LATAM South 2022 - Stage 2 Challengers - Group Stage","Haven",683,"9z Team",976,"KRÜ Esports",1,7,13,2,10,1,0,1,2,10,5,3,1,0,1,3,5,10,2,"standard","2022-05-22T00:00:00.000Z","[3506,9905,855,1376,3510]","[4712,3535,2532,1725,4710]","Breach,Sova,Killjoy,Omen,Jett","Breach,Omen,Chamber,Neon,Fade",1588
65605,29384,"VCT Brazil 2022 - Stage 2 Challengers 1 - Group Stage","Bind",5748,"Los Grandes",6344,"LOUD",2,8,13,5,7,1,1,0,3,6,5,7,1,1,0,7,5,6,3,"standard","2022-05-22T00:00:00.000Z","[6231,4770,2103,669,2420]","[4748,4746,2895,6037,2294]","Breach,Raze,Astra,Chamber,Fade","Raze,Viper,Skye,Astra,Fade",1588
65632,29393,"VCT North America 2022 - Stage 2 Challengers - Group Stage","Icebox",6426,"OpTic Gaming",141,"Cloud9",2,4,13,4,8,1,0,1,0,5,4,8,1,0,1,8,4,5,0,"standard","2022-05-22T00:00:00.000Z","[2483,398,2841,3211,2716]","[3773,2213,4639,3599,13591]","Sova,Viper,Sage,KAY/O,Chamber","Viper,Sage,KAY/O,Chamber,Fade",1588
66469,29759,"VCT LATAM South 2022 - Stage 2 Challengers - Group Stage","Breeze",7014,"SunXet Club",5106,"PAMPAS",2,8,13,6,6,0,0,0,2,7,6,6,2,1,1,6,6,7,2,"standard","2022-05-22T00:00:00.000Z","[3504,5907,3458,3503,3719]","[3718,32,3538,5709,4601]","Sova,Viper,Astra,KAY/O,Chamber","Cypher,Sova,Viper,Jett,KAY/O",1588
66468,29759,"VCT LATAM South 2022 - Stage 2 Challengers - Group Stage","Ascent",7014,"SunXet Club",5106,"PAMPAS",1,2,13,1,11,1,0,1,1,11,1,2,1,0,1,2,1,11,1,"standard","2022-05-22T00:00:00.000Z","[3504,5907,3503,3458,3719]","[3718,3538,5709,4601,32]","Sova,Killjoy,Sage,Omen,Jett","Killjoy,Omen,Jett,KAY/O,Fade",1588
66292,29681,"VCT EMEA 2022 - Stage 2 Challengers - Group Stage","Icebox",5439,"FOKUS",2597,"Acend",2,9,13,7,5,1,0,1,2,8,7,5,1,0,1,5,7,8,2,"standard","2022-05-22T00:00:00.000Z","[3150,4227,5687,20802,7669]","[87,1268,732,2391,691]","Sova,Killjoy,Viper,Jett,KAY/O","Sova,Viper,Reyna,KAY/O,Chamber",1588
66291,29681,"VCT EMEA 2022 - Stage 2 Challengers - Group Stage","Ascent",5439,"FOKUS",2597,"Acend",1,8,13,4,8,1,0,1,4,8,4,5,1,0,1,5,4,8,4,"standard","2022-05-22T00:00:00.000Z","[3150,5687,4227,20802,7669]","[87,1268,691,732,2391]","Sova,Killjoy,Omen,Jett,KAY/O","Sova,Killjoy,Omen,Jett,KAY/O",1588
66290,29681,"VCT EMEA 2022 - Stage 2 Challengers - Group Stage","Bind",5439,"FOKUS",2597,"Acend",2,13,7,6,6,2,1,1,7,1,6,6,0,0,0,6,6,1,7,"standard","2022-05-22T00:00:00.000Z","[7669,5687,3150,20802,4227]","[2391,1268,87,732,691]","Raze,Viper,Brimstone,Jett,Skye","Raze,Viper,Brimstone,Sage,Skye",1588
66295,29682,"VCT EMEA 2022 - Stage 2 Challengers - Group Stage","Icebox",4220,"Natus Vincere",6656,"M3 Champions",1,3,13,3,9,0,0,0,3,9,0,4,2,1,1,4,0,9,3,"standard","2022-05-22T00:00:00.000Z","[2983,2279,491,3003,999]","[1964,1081,274,2528,3135]","Sova,Killjoy,Viper,Sage,Chamber","Sova,Viper,Brimstone,KAY/O,Chamber",1588
66294,29682,"VCT EMEA 2022 - Stage 2 Challengers - Group Stage","Bind",4220,"Natus Vincere",6656,"M3 Champions",2,13,4,9,3,2,1,1,4,1,9,3,0,0,0,3,9,1,4,"standard","2022-05-22T00:00:00.000Z","[2983,2279,491,3003,999]","[3135,1081,274,2528,1964]","Raze,Viper,Omen,Skye,Chamber","Raze,Viper,Brimstone,Skye,Fade",1588
66293,29682,"VCT EMEA 2022 - Stage 2 Challengers - Group Stage","Ascent",4220,"Natus Vincere",6656,"M3 Champions",1,5,13,3,9,0,0,0,3,9,2,4,2,1,1,4,2,9,3,"standard","2022-05-22T00:00:00.000Z","[2983,2279,491,999,3003]","[2528,274,3135,1081,1964]","Sova,Killjoy,Omen,Jett,KAY/O","Sova,Killjoy,Jett,Astra,KAY/O",1588
67333,30180,"VCT Japan 2022 - Stage 2 Challengers - Main Event","Icebox",611,"ZETA DIVISION",334,"REJECT",2,13,11,5,7,1,1,0,8,4,5,7,1,1,0,7,5,4,8,"standard","2022-05-22T00:00:00.000Z","[2699,2232,519,1593,2212]","[705,3011,2791,852,2584]","Sova,Viper,Sage,Jett,Chamber","Sova,Viper,Reyna,Chamber,Fade",1588
65177,29210,"VCT Korea 2022 - Stage 2 Challengers - Group Stage","Ascent",1267,"Spear Gaming",7156,"Tartarus",1,13,6,9,3,2,1,1,9,3,4,3,0,0,0,3,4,3,9,"standard","2022-05-22T00:00:00.000Z","[6600,18839,15737,8076,18840]","[679,15738,22846,745,6740]","Killjoy,Omen,Jett,KAY/O,Fade","Sova,Killjoy,Omen,Jett,KAY/O",1588
67332,30180,"VCT Japan 2022 - Stage 2 Challengers - Main Event","Bind",611,"ZETA DIVISION",334,"REJECT",1,13,6,10,2,1,1,0,10,2,3,4,1,1,0,4,3,2,10,"standard","2022-05-22T00:00:00.000Z","[519,2232,1593,2212,2699]","[3011,2584,2791,852,705]","Raze,Viper,Omen,Chamber,Fade","Raze,Viper,Brimstone,Skye,Chamber",1588
65176,29210,"VCT Korea 2022 - Stage 2 Challengers - Group Stage","Fracture",1267,"Spear Gaming",7156,"Tartarus",1,4,13,4,8,1,1,0,4,8,0,5,1,1,0,5,0,8,4,"standard","2022-05-22T00:00:00.000Z","[6600,18840,8076,18839,15737]","[679,22846,745,6740,15738]","Breach,Brimstone,KAY/O,Chamber,Neon","Breach,Brimstone,Jett,KAY/O,Chamber",1588
67331,30180,"VCT Japan 2022 - Stage 2 Challengers - Main Event","Haven",611,"ZETA DIVISION",334,"REJECT",2,3,13,3,9,1,0,1,0,4,3,9,1,0,1,9,3,4,0,"standard","2022-05-22T00:00:00.000Z","[2699,2232,519,2212,1593]","[705,2791,852,2584]","Breach,Omen,KAY/O,Chamber,Fade","Breach,Raze,Chamber,Fade",1588
65175,29210,"VCT Korea 2022 - Stage 2 Challengers - Group Stage","Breeze",1267,"Spear Gaming",7156,"Tartarus",1,13,5,8,4,1,0,1,8,4,5,1,1,0,1,1,5,4,8,"standard","2022-05-22T00:00:00.000Z","[18840,8076,15737,18839,6600]","[679,22846,745,6740,15738]","Sova,Viper,Jett,KAY/O,Chamber","Sova,Viper,Jett,KAY/O,Chamber",1588
67327,30178,"VCT Japan 2022 - Stage 2 Challengers - Main Event","Icebox",483,"Crest Gaming ZST",334,"REJECT",2,2,13,2,10,0,0,0,0,3,2,10,2,1,1,10,2,3,0,"standard","2022-05-22T00:00:00.000Z","[3020,12262,2341,6773,2109]","[705,3011,2791,852,2584]","Sova,Viper,Sage,Jett,Chamber","Sova,Viper,Reyna,Chamber,Fade",1588
65174,29209,"VCT Korea 2022 - Stage 2 Challengers - Group Stage","Ascent",1515,"World Game Star",6406,"CNJ Esports",2,13,10,6,6,2,1,1,7,4,6,6,0,0,0,6,6,4,7,"standard","2022-05-22T00:00:00.000Z","[2650,23167,3522,15724,293]","[225,6692,1008,2306,6738]","Raze,Reyna,Omen,KAY/O,Fade","Raze,Omen,KAY/O,Chamber,Fade",1588
67326,30178,"VCT Japan 2022 - Stage 2 Challengers - Main Event","Bind",483,"Crest Gaming ZST",334,"REJECT",1,5,13,2,10,1,0,1,2,10,3,3,1,0,1,3,3,10,2,"standard","2022-05-22T00:00:00.000Z","[2341,3020,2109,12262,6773]","[3011,2584,2791,852,705]","Raze,Sage,Skye,Astra,Chamber","Raze,Viper,Brimstone,Skye,Chamber",1588
67325,30178,"VCT Japan 2022 - Stage 2 Challengers - Main Event","Fracture",483,"Crest Gaming ZST",334,"REJECT",2,13,9,5,7,2,1,1,8,2,5,7,0,0,0,7,5,2,8,"standard","2022-05-22T00:00:00.000Z","[705,2791,852,3011,2584]","[3020,12262,6773,2341,2109]","Breach,Astra,Chamber,Neon,Fade","Breach,Raze,Brimstone,Sage,Chamber",1588
65173,29209,"VCT Korea 2022 - Stage 2 Challengers - Group Stage","Icebox",1515,"World Game Star",6406,"CNJ Esports",2,7,13,5,7,1,0,1,2,6,5,7,1,0,1,7,5,6,2,"standard","2022-05-22T00:00:00.000Z","[2650,3522,2687,23167,293]","[6738,6692,2306,225,1008]","Raze,Viper,Sage,Chamber,Fade","Sova,Viper,Reyna,Chamber,Fade",1588
65172,29209,"VCT Korea 2022 - Stage 2 Challengers - Group Stage","Fracture",1515,"World Game Star",6406,"CNJ Esports",1,13,5,10,2,0,0,0,10,2,3,3,2,1,1,3,3,2,10,"standard","2022-05-22T00:00:00.000Z","[293,2687,3522,23167,2650]","[6738,225,6692,1008,2306]","Breach,Viper,Brimstone,Chamber,Neon","Breach,Raze,Brimstone,KAY/O,Chamber",1588
67320,30176,"VCT Japan 2022 - Stage 2 Challengers - Main Event","Breeze",5219,"Reignite",611,"ZETA DIVISION",1,8,13,5,7,1,0,1,5,7,3,6,1,0,1,6,3,7,5,"standard","2022-05-22T00:00:00.000Z","[25129,10573,9555,921,443]","[2699,2232,1593,519,2212]","Breach,Raze,Killjoy,Viper,Fade","Sova,Viper,Jett,Skye,Chamber",1588
67319,30176,"VCT Japan 2022 - Stage 2 Challengers - Main Event","Haven",5219,"Reignite",611,"ZETA DIVISION",1,9,13,6,6,1,1,0,6,6,3,7,1,1,0,7,3,6,6,"standard","2022-05-22T00:00:00.000Z","[25129,9555,921,10573,443]","[2699,2232,519,2212,1593]","Breach,Killjoy,Omen,Jett,Skye","Breach,Omen,KAY/O,Chamber,Fade",1588
65613,29386,"VCT Brazil 2022 - Stage 2 Challengers 1 - Group Stage","Haven",5747,"TBK Esports",5675,"MIBR",1,11,13,7,5,1,0,1,7,5,4,8,1,0,1,8,4,5,7,"standard","2022-05-22T00:00:00.000Z","[2457,9831,5580,1506,2366]","[3105,211,1877,4577,11296]","Breach,Omen,Skye,Chamber,Neon","Breach,Sova,Killjoy,Omen,Jett",1588
65612,29386,"VCT Brazil 2022 - Stage 2 Challengers 1 - Group Stage","Bind",5747,"TBK Esports",5675,"MIBR",1,14,12,4,8,1,0,1,5,8,9,4,1,0,1,4,9,8,5,"standard","2022-05-22T00:00:00.000Z","[2366,2457,9831,1506,5580]","[11296,4577,3105,211,1877]","Raze,Viper,Brimstone,Sage,Skye","Raze,Viper,Brimstone,Skye,Chamber",1588
65640,29395,"VCT LATAM South 2022 - Stage 2 Challengers - Group Stage","Fracture",1503,"Movistar Optix",738,"Leviatán",1,2,13,2,10,0,0,0,2,10,0,3,2,1,1,3,0,10,2,"standard","2022-05-22T00:00:00.000Z","[3409,1579,3411,14762,14764]","[3531,3421,3555,3532,6414]","Breach,Cypher,Brimstone,KAY/O,Neon","Breach,Brimstone,KAY/O,Chamber,Neon",1588
65611,29386,"VCT Brazil 2022 - Stage 2 Challengers 1 - Group Stage","Ascent",5747,"TBK Esports",5675,"MIBR",1,9,13,2,10,0,0,0,2,10,7,3,2,1,1,3,7,10,2,"standard","2022-05-22T00:00:00.000Z","[2366,2457,5580,1506,9831]","[11296,4577,3105,1877,211]","Raze,Astra,KAY/O,Chamber,Fade","Raze,Omen,KAY/O,Chamber,Fade",1588
65630,29392,"VCT North America 2022 - Stage 2 Challengers - Group Stage","Icebox",1448,"Evil Geniuses",388,"Sentinels",1,13,10,6,6,2,1,1,6,6,7,4,0,0,0,4,7,6,6,"standard","2022-05-21T00:00:00.000Z","[2882,3842,11672,4157,1023]","[893,724,1614,3033,1249]","Sova,Viper,Sage,Jett,Chamber","Sova,Viper,Sage,Jett,Chamber",1588
65639,29395,"VCT LATAM South 2022 - Stage 2 Challengers - Group Stage","Icebox",1503,"Movistar Optix",738,"Leviatán",1,7,13,5,7,1,1,0,5,7,2,6,1,1,0,6,2,7,5,"standard","2022-05-21T00:00:00.000Z","[1579,3411,3409,14764,14762]","[3531,6414,3421,3555,3532]","Sova,Viper,Sage,Reyna,Chamber","Sova,Viper,Sage,KAY/O,Chamber",1588
65610,29385,"VCT Brazil 2022 - Stage 2 Challengers 1 - Group Stage","Ascent",5750,"Ninjas in Pyjamas",600,"Keyd Stars",1,13,11,6,6,2,1,1,6,6,7,5,0,0,0,5,7,6,6,"standard","2022-05-21T00:00:00.000Z","[16804,762,2901,3203,2195]","[81,957,4771,277,5288]","Sova,Killjoy,Omen,Jett,Fade","Raze,Sova,Omen,KAY/O,Chamber",1588
65629,29392,"VCT North America 2022 - Stage 2 Challengers - Group Stage","Ascent",1448,"Evil Geniuses",388,"Sentinels",2,13,11,6,6,2,1,1,7,5,6,6,0,0,0,6,6,5,7,"standard","2022-05-21T00:00:00.000Z","[4157,2882,3842,11672,1023]","[893,724,1614,3033,1249]","Raze,Sova,Omen,KAY/O,Chamber","Sova,Killjoy,Omen,Jett,KAY/O",1588
65638,29395,"VCT LATAM South 2022 - Stage 2 Challengers - Group Stage","Ascent",1503,"Movistar Optix",738,"Leviatán",2,14,12,4,8,1,1,0,9,4,5,8,1,1,0,8,5,4,9,"standard","2022-05-21T00:00:00.000Z","[3409,1579,14764,3411,14762]","[3531,3421,3555,3532,6414]","Sova,Killjoy,Jett,Astra,KAY/O","Sova,Omen,KAY/O,Chamber,Neon",1588
65609,29385,"VCT Brazil 2022 - Stage 2 Challengers 1 - Group Stage","Split",5750,"Ninjas in Pyjamas",600,"Keyd Stars",1,9,13,6,6,2,1,1,6,6,3,7,0,0,0,7,3,6,6,"standard","2022-05-21T00:00:00.000Z","[3203,762,16804,2901,2195]","[957,81,277,4771,5288]","Raze,Cypher,Sage,Omen,Jett","Breach,Raze,Sage,Omen,Chamber",1588
65621,29389,"VCT North America 2022 - Stage 2 Challengers - Group Stage","Haven",278,"TSM",305,"100 Thieves",1,13,6,9,3,2,1,1,9,3,4,3,0,0,0,3,4,3,9,"standard","2022-05-21T00:00:00.000Z","[5305,2098,2479,1217,4239]","[269,1012,2354,763,122]","Breach,Omen,Skye,Chamber,Neon","Breach,Omen,Jett,Skye,Chamber",1588
65637,29394,"VCT LATAM South 2022 - Stage 2 Challengers - Group Stage","Breeze",7014,"SunXet Club",683,"9z Team",1,9,13,2,10,1,0,1,2,10,7,3,1,0,1,3,7,10,2,"standard","2022-05-21T00:00:00.000Z","[3504,5907,3458,3503,3719]","[9905,1376,3510,855,3506]","Sova,Viper,Astra,KAY/O,Chamber","Sova,Viper,KAY/O,Chamber,Fade",1588
65608,29385,"VCT Brazil 2022 - Stage 2 Challengers 1 - Group Stage","Haven",5750,"Ninjas in Pyjamas",600,"Keyd Stars",1,13,9,5,7,1,0,1,5,7,8,2,1,0,1,2,8,7,5,"standard","2022-05-21T00:00:00.000Z","[2901,16804,762,3203,2195]","[957,81,4771,277,5288]","Omen,Skye,KAY/O,Chamber,Neon","Breach,Raze,Omen,Skye,Chamber",1588
65620,29389,"VCT North America 2022 - Stage 2 Challengers - Group Stage","Split",278,"TSM",305,"100 Thieves",2,13,10,8,4,1,0,1,5,6,8,4,1,0,1,4,8,6,5,"standard","2022-05-21T00:00:00.000Z","[4239,5305,2479,2098,1217]","[2354,122,269,1012,763]","Raze,Viper,Skye,Astra,Chamber","Raze,Cypher,Sage,Omen,Skye",1588
65636,29394,"VCT LATAM South 2022 - Stage 2 Challengers - Group Stage","Icebox",7014,"SunXet Club",683,"9z Team",1,9,13,5,7,1,1,0,5,7,4,6,1,1,0,6,4,7,5,"standard","2022-05-21T00:00:00.000Z","[3504,5907,3458,3503,3719]","[9905,1376,3506,3510,855]","Sova,Viper,Sage,KAY/O,Chamber","Sova,Viper,Sage,Jett,Chamber",1588
65635,29394,"VCT LATAM South 2022 - Stage 2 Challengers - Group Stage","Ascent",7014,"SunXet Club",683,"9z Team",2,13,10,6,6,1,1,0,7,4,6,6,1,1,0,6,6,4,7,"standard","2022-05-21T00:00:00.000Z","[3504,5907,3503,3458,3719]","[9905,855,1376,3510,3506]","Sova,Killjoy,Sage,Omen,Jett","Sova,Sage,Omen,KAY/O,Chamber",1588
66286,29679,"VCT EMEA 2022 - Stage 2 Challengers - Group Stage","Haven",329,"BIG",386,"Guild Esports",2,6,13,6,6,0,0,0,0,7,6,6,2,1,1,6,6,7,0,"standard","2022-05-21T00:00:00.000Z","[1828,1538,2326,360,819]","[2318,449,1834,2321,966]","Breach,Raze,Omen,Chamber,Fade","Breach,Sova,Killjoy,Omen,Jett",1588
66285,29679,"VCT EMEA 2022 - Stage 2 Challengers - Group Stage","Fracture",329,"BIG",386,"Guild Esports",2,13,11,7,5,1,0,1,6,6,7,5,1,0,1,5,7,6,6,"standard","2022-05-21T00:00:00.000Z","[819,1538,2326,360,1828]","[2318,2321,449,1834,966]","Breach,Raze,Brimstone,Sage,Chamber","Breach,Brimstone,KAY/O,Chamber,Neon",1588
66284,29679,"VCT EMEA 2022 - Stage 2 Challengers - Group Stage","Icebox",329,"BIG",386,"Guild Esports",1,10,13,7,5,1,1,0,7,5,3,8,1,1,0,8,3,5,7,"standard","2022-05-21T00:00:00.000Z","[1828,2326,819,1538,360]","[449,2321,2318,966,1834]","Sova,Viper,Omen,Jett,Chamber","Sova,Viper,Sage,Jett,Chamber",1588
66288,29680,"VCT EMEA 2022 - Stage 2 Challengers - Group Stage","Ascent",17,"FunPlus Phoenix",194,"G2 Esports (Inactive)",1,13,10,8,4,0,0,0,8,4,5,6,2,1,1,6,5,4,8,"standard","2022-05-21T00:00:00.000Z","[2225,2335,3043,1256,2359]","[1826,2377,2769,2594,2940]","Sage,Omen,Jett,KAY/O,Fade","Raze,Sova,Omen,KAY/O,Chamber",1588
66287,29680,"VCT EMEA 2022 - Stage 2 Challengers - Group Stage","Fracture",17,"FunPlus Phoenix",194,"G2 Esports (Inactive)",2,13,9,6,6,1,1,0,7,3,6,6,1,1,0,6,6,3,7,"standard","2022-05-21T00:00:00.000Z","[2225,2335,1256,3043,2359]","[2377,2769,2594,2940,1826]","Sage,Omen,KAY/O,Chamber,Fade","Breach,Brimstone,KAY/O,Chamber,Neon",1588
67317,30175,"VCT Japan 2022 - Stage 2 Challengers - Main Event","Fracture",1840,"NORTHEPTION",488,"FAV gaming",1,13,6,8,4,1,1,0,8,4,5,2,1,1,0,2,5,4,8,"standard","2022-05-21T00:00:00.000Z","[3060,652,8882,12341,2272]","[9576,1824,8883,314,3035]","Breach,Raze,Brimstone,Chamber,Neon","Breach,Raze,Cypher,Sage,Astra",1588
67316,30175,"VCT Japan 2022 - Stage 2 Challengers - Main Event","Split",1840,"NORTHEPTION",488,"FAV gaming",2,13,7,8,4,1,0,1,5,3,8,4,1,0,1,4,8,3,5,"standard","2022-05-21T00:00:00.000Z","[3060,2272,8882,12341,652]","[9576,1824,314,8883,3035]","Breach,Sage,Omen,Jett,Chamber","Breach,Raze,Cypher,Sage,Astra",1588
65170,29208,"VCT Korea 2022 - Stage 2 Challengers - Group Stage","Ascent",997,"DAMWON Gaming",286,"DRX",2,6,13,5,7,0,0,0,1,6,5,7,2,1,1,7,5,6,1,"standard","2022-05-21T00:00:00.000Z","[315,2368,2240,6546,4811]","[814,452,1550,1251,582]","Breach,Sova,Omen,KAY/O,Chamber","Sova,Astra,KAY/O,Chamber,Fade",1588
65169,29208,"VCT Korea 2022 - Stage 2 Challengers - Group Stage","Bind",997,"DAMWON Gaming",286,"DRX",2,6,13,2,10,1,1,0,4,3,2,10,1,1,0,10,2,3,4,"standard","2022-05-21T00:00:00.000Z","[315,4811,2240,6546,2368]","[582,452,1251,1550,814]","Breach,Raze,Brimstone,Sage,Skye","Breach,Brimstone,Chamber,Neon,Fade",1588
67314,30174,"VCT Japan 2022 - Stage 2 Challengers - Main Event","Icebox",488,"FAV gaming",5218,"Jadeite",1,13,10,8,4,1,1,0,8,4,5,6,1,1,0,6,5,4,8,"standard","2022-05-21T00:00:00.000Z","[9576,3035,8883,1824,314]","[147,1917,12282,1746,371]","Sova,Viper,Sage,Jett,KAY/O","Sova,Viper,Sage,Jett,Chamber",1588
67313,30174,"VCT Japan 2022 - Stage 2 Challengers - Main Event","Bind",488,"FAV gaming",5218,"Jadeite",2,13,7,7,5,2,1,1,6,2,7,5,0,0,0,5,7,2,6,"standard","2022-05-21T00:00:00.000Z","[1824,9576,8883,314,3035]","[147,12282,1917,1746,371]","Raze,Viper,Sage,Skye,Astra","Breach,Raze,Brimstone,Yoru,Fade",1588
65167,29207,"VCT Korea 2022 - Stage 2 Challengers - Group Stage","Ascent",6366,"Maru Gaming",5373,"On Sla2ers",1,7,13,4,8,0,0,0,4,8,3,5,2,1,1,5,3,8,4,"standard","2022-05-21T00:00:00.000Z","[8382,2762,4229,6719,6595]","[2151,1075,2009,2904,1199]","Jett,Astra,KAY/O,Chamber,Fade","Killjoy,Yoru,Astra,KAY/O,Fade",1588
65166,29207,"VCT Korea 2022 - Stage 2 Challengers - Group Stage","Breeze",6366,"Maru Gaming",5373,"On Sla2ers",2,7,13,4,8,1,1,0,3,5,4,8,1,1,0,8,4,5,3,"standard","2022-05-21T00:00:00.000Z","[6595,2762,8382,4229,6719]","[2151,1199,2009,1075,2904]","Sova,Viper,Jett,KAY/O,Chamber","Cypher,Sova,Viper,Yoru,KAY/O",1588
67312,30173,"VCT Japan 2022 - Stage 2 Challengers - Main Event","Ascent",1840,"NORTHEPTION",444,"Crazy Raccoon",1,13,10,4,8,1,1,0,4,8,9,2,1,1,0,2,9,8,4,"standard","2022-05-21T00:00:00.000Z","[2272,8882,12341,652,3060]","[2388,1886,815,8025,1231]","Killjoy,Omen,Jett,KAY/O,Fade","Raze,Killjoy,Omen,KAY/O,Fade",1588
67311,30173,"VCT Japan 2022 - Stage 2 Challengers - Main Event","Breeze",1840,"NORTHEPTION",444,"Crazy Raccoon",2,11,13,7,5,0,0,0,4,8,7,5,2,1,1,5,7,8,4,"standard","2022-05-21T00:00:00.000Z","[2272,8882,12341,3060,652]","[815,1231,8025,1886,2388]","Sova,Viper,Jett,Skye,Chamber","Cypher,Sova,Viper,Jett,KAY/O",1588
67310,30173,"VCT Japan 2022 - Stage 2 Challengers - Main Event","Haven",1840,"NORTHEPTION",444,"Crazy Raccoon",1,13,4,9,3,1,1,0,9,3,4,1,1,1,0,1,4,3,9,"standard","2022-05-21T00:00:00.000Z","[3060,2272,12341,652,8882]","[8025,2388,1886,815,1231]","Breach,Killjoy,Jett,Skye,Astra","Breach,Raze,Killjoy,Omen,Skye",1588
65619,29388,"VCT North America 2022 - Stage 2 Challengers - Group Stage","Fracture",978,"Ghost Gaming",5201,"The Guard",1,13,8,7,5,2,1,1,7,5,6,3,0,0,0,3,6,5,7,"standard","2022-05-21T00:00:00.000Z","[1468,1780,3074,1578,3016]","[4141,1091,1804,11412,2551]","Breach,Raze,Brimstone,Sage,Chamber","Breach,Raze,Brimstone,Sage,Chamber",1588
65618,29388,"VCT North America 2022 - Stage 2 Challengers - Group Stage","Ascent",978,"Ghost Gaming",5201,"The Guard",1,8,13,2,10,1,0,1,2,10,6,3,1,0,1,3,6,10,2,"standard","2022-05-20T00:00:00.000Z","[1780,3074,1578,3016,1468]","[4141,11412,1804,1091,2551]","Raze,Astra,KAY/O,Chamber,Fade","Breach,Sova,Omen,Jett,Chamber",1588
65617,29388,"VCT North America 2022 - Stage 2 Challengers - Group Stage","Haven",978,"Ghost Gaming",5201,"The Guard",2,13,1,11,1,2,1,1,2,0,11,1,0,0,0,1,11,0,2,"standard","2022-05-20T00:00:00.000Z","[1468,1780,3074,3016,1578]","[4141,1804,1091,11412,2551]","Breach,Raze,Astra,Chamber,Fade","Breach,Omen,Jett,Skye,Chamber",1588
65627,29391,"VCT North America 2022 - Stage 2 Challengers - Group Stage","Icebox",617,"FaZe Clan",279,"Luminosity Gaming",1,12,14,6,6,0,0,0,6,7,6,7,2,1,1,7,6,7,6,"standard","2022-05-20T00:00:00.000Z","[1689,1994,369,1990,789]","[1801,2489,1522,3345,905]","Sova,Viper,Jett,KAY/O,Chamber","Raze,Sova,Viper,Sage,Chamber",1588
65626,29391,"VCT North America 2022 - Stage 2 Challengers - Group Stage","Fracture",617,"FaZe Clan",279,"Luminosity Gaming",2,11,13,5,7,1,1,0,6,6,5,7,1,1,0,7,5,6,6,"standard","2022-05-20T00:00:00.000Z","[1689,1994,1990,789,369]","[2489,1801,3345,1522,905]","Breach,Brimstone,KAY/O,Chamber,Neon","Breach,Raze,Brimstone,KAY/O,Chamber",1588
65588,29368,"VCT EMEA 2022 - Stage 2 Challengers - Group Stage","Icebox",7050,"OG LDN UTD",1625,"FNATIC",2,0,13,0,12,0,0,0,0,1,0,12,2,1,1,12,0,1,0,"standard","2022-05-20T00:00:00.000Z","[2199,2305,2561,1894,426]","[718,14543,2011,76,2937]","Viper,Sage,KAY/O,Chamber,Fade","Sova,Killjoy,Viper,Sage,Chamber",1588
65587,29368,"VCT EMEA 2022 - Stage 2 Challengers - Group Stage","Haven",7050,"OG LDN UTD",1625,"FNATIC",1,4,13,3,9,0,0,0,3,9,1,4,2,1,1,4,1,9,3,"standard","2022-05-20T00:00:00.000Z","[426,2561,2199,2305,1894]","[76,14543,718,2011,2937]","Breach,Sova,Killjoy,Omen,Jett","Breach,Raze,Sova,Omen,Chamber",1588
65585,29367,"VCT EMEA 2022 - Stage 2 Challengers - Group Stage","Split",520,"BBL Esports",224,"Team Liquid",2,9,13,5,7,1,1,0,4,6,5,7,1,1,0,7,5,6,4,"standard","2022-05-20T00:00:00.000Z","[1749,9643,2864,3152,1852]","[1403,1690,17788,10211,2056]","Breach,Raze,Sage,Omen,Chamber","Breach,Raze,Cypher,Omen,Astra",1588
65584,29367,"VCT EMEA 2022 - Stage 2 Challengers - Group Stage","Fracture",520,"BBL Esports",224,"Team Liquid",1,14,16,7,5,0,0,0,8,7,6,9,2,1,1,9,6,7,8,"standard","2022-05-20T00:00:00.000Z","[1749,3152,2864,1852,9643]","[1403,1690,17788,10211,2056]","Breach,Brimstone,Sage,Chamber,Neon","Breach,Raze,Cypher,Skye,Astra",1588
64143,28811,"VCT Brazil 2022 - Stage 2 Challengers 1 - Group Stage","Split",5750,"Ninjas in Pyjamas",319,"Liberty",1,15,13,8,4,2,1,1,9,5,6,8,0,0,0,8,6,5,9,"standard","2022-05-16T00:00:00.000Z","[3203,762,16804,2901,2195]","[4745,986,2054,2927,23522]","Raze,Cypher,Sage,Omen,Jett","Raze,Sage,Omen,Skye,Chamber",1588
64649,29013,"VCT North America 2022 - Stage 2 Challengers - Group Stage","Fracture",141,"Cloud9",1448,"Evil Geniuses",1,13,9,7,5,0,0,0,7,5,6,4,2,1,1,4,6,5,7,"standard","2022-05-15T00:00:00.000Z","[1961,13591,4639,2213,3599]","[2882,4157,3842,11672,1023]","Breach,Raze,Brimstone,Sage,Chamber","Breach,Raze,Brimstone,Sage,Chamber",1588
64142,28811,"VCT Brazil 2022 - Stage 2 Challengers 1 - Group Stage","Fracture",5750,"Ninjas in Pyjamas",319,"Liberty",2,13,9,8,4,1,0,1,5,5,8,4,1,0,1,4,8,5,5,"standard","2022-05-15T00:00:00.000Z","[762,2901,16804,3203,2195]","[2927,4745,986,2054,23522]","Breach,Brimstone,KAY/O,Chamber,Neon","Breach,Raze,Cypher,Viper,Brimstone",1588
64648,29013,"VCT North America 2022 - Stage 2 Challengers - Group Stage","Icebox",141,"Cloud9",1448,"Evil Geniuses",2,15,13,4,8,2,1,1,9,5,6,8,0,0,0,8,6,5,9,"standard","2022-05-15T00:00:00.000Z","[1961,2213,4639,3599,13591]","[2882,3842,11672,4157,1023]","Viper,Sage,KAY/O,Chamber,Fade","Sova,Viper,Sage,Jett,Chamber",1588
64324,28868,"VCT LATAM South 2022 - Stage 2 Challengers - Group Stage","Ascent",7014,"SunXet Club",1503,"Movistar Optix",1,15,13,6,6,1,0,1,7,7,8,6,1,0,1,6,8,7,7,"standard","2022-05-15T00:00:00.000Z","[3504,5907,3503,3458,3719]","[3409,1579,14764,3411,14762]","Sova,Killjoy,Sage,Omen,Jett","Sova,Killjoy,Jett,Astra,KAY/O",1588
64141,28810,"VCT Brazil 2022 - Stage 2 Challengers 1 - Group Stage","Icebox",5675,"MIBR",600,"Keyd Stars",1,13,3,9,3,2,1,1,9,3,4,0,0,0,0,0,4,3,9,"standard","2022-05-15T00:00:00.000Z","[211,1877,4577,3105,11296]","[81,4771,957,277,5288]","Sova,Viper,Sage,KAY/O,Chamber","Sova,Viper,Sage,KAY/O,Chamber",1588
64646,29012,"VCT North America 2022 - Stage 2 Challengers - Group Stage","Ascent",116,"NRG Esports",278,"TSM",2,13,10,8,4,2,1,1,5,6,8,4,0,0,0,4,8,6,5,"standard","2022-05-15T00:00:00.000Z","[165,1232,10253,1763,1597]","[1217,5305,2479,4239,2098]","Raze,Omen,KAY/O,Chamber,Fade","Raze,Sova,Astra,Chamber,Fade",1588
64140,28810,"VCT Brazil 2022 - Stage 2 Challengers 1 - Group Stage","Haven",5675,"MIBR",600,"Keyd Stars",2,7,13,6,6,1,0,1,1,7,6,6,1,0,1,6,6,7,1,"standard","2022-05-15T00:00:00.000Z","[4577,3105,1877,11296,211]","[957,81,4771,277,5288]","Omen,Skye,Chamber,Neon,Fade","Breach,Raze,Omen,Skye,Chamber",1588
64323,28868,"VCT LATAM South 2022 - Stage 2 Challengers - Group Stage","Bind",7014,"SunXet Club",1503,"Movistar Optix",2,16,14,4,8,2,1,1,9,6,7,8,0,0,0,8,7,6,9,"standard","2022-05-15T00:00:00.000Z","[3504,5907,3458,3503,3719]","[14764,3409,3411,14762,1579]","Raze,Viper,Brimstone,Skye,Chamber","Raze,Viper,Brimstone,Skye,Chamber",1588
64139,28810,"VCT Brazil 2022 - Stage 2 Challengers 1 - Group Stage","Bind",5675,"MIBR",600,"Keyd Stars",2,13,5,10,2,1,0,1,3,3,10,2,1,0,1,2,10,3,3,"standard","2022-05-15T00:00:00.000Z","[11296,4577,3105,211,1877]","[81,277,4771,957,5288]","Raze,Viper,Brimstone,Skye,Chamber","Raze,Viper,Brimstone,Skye,Chamber",1588
64645,29012,"VCT North America 2022 - Stage 2 Challengers - Group Stage","Breeze",116,"NRG Esports",278,"TSM",2,15,13,6,6,1,0,1,7,7,8,6,1,0,1,6,8,7,7,"standard","2022-05-15T00:00:00.000Z","[1597,1232,165,10253,1763]","[5305,2479,1217,4239,2098]","Sova,Viper,Omen,Skye,Chamber","Sova,Viper,Jett,Chamber,Fade",1588
64321,28867,"VCT LATAM South 2022 - Stage 2 Challengers - Group Stage","Ascent",5106,"PAMPAS",738,"Leviatán",2,3,13,3,9,0,0,0,0,4,3,9,2,1,1,9,3,4,0,"standard","2022-05-15T00:00:00.000Z","[5709,3718,3538,4601,32]","[3531,3421,3555,3532,6414]","Raze,Killjoy,Omen,KAY/O,Fade","Sova,Omen,KAY/O,Chamber,Neon",1588
64320,28867,"VCT LATAM South 2022 - Stage 2 Challengers - Group Stage","Haven",5106,"PAMPAS",738,"Leviatán",1,8,13,6,6,0,0,0,6,6,2,7,2,1,1,7,2,6,6,"standard","2022-05-15T00:00:00.000Z","[4601,5709,3718,32,3538]","[3421,3531,3555,3532,6414]","Breach,Raze,Cypher,Sova,Omen","Omen,Skye,KAY/O,Chamber,Neon",1588
64619,29003,"VCT EMEA 2022 - Stage 2 Challengers - Group Stage","Icebox",194,"G2 Esports (Inactive)",5439,"FOKUS",1,13,11,5,7,1,0,1,5,7,8,4,1,0,1,4,8,7,5,"standard","2022-05-15T00:00:00.000Z","[1826,2377,2769,2594,2940]","[3150,5687,20802,7669,4227]","Sova,Killjoy,Viper,Sage,Chamber","Sova,Viper,Jett,KAY/O,Chamber",1588
64618,29003,"VCT EMEA 2022 - Stage 2 Challengers - Group Stage","Fracture",194,"G2 Esports (Inactive)",5439,"FOKUS",2,14,12,8,4,0,0,0,5,8,9,4,2,1,1,4,9,8,5,"standard","2022-05-15T00:00:00.000Z","[2377,2769,2594,2940,1826]","[3150,7669,5687,4227,20802]","Breach,Brimstone,KAY/O,Chamber,Neon","Breach,Raze,Cypher,Brimstone,Neon",1588
64622,29004,"VCT EMEA 2022 - Stage 2 Challengers - Group Stage","Haven",386,"Guild Esports",6656,"M3 Champions",1,13,6,10,2,2,1,1,10,2,3,4,0,0,0,4,3,2,10,"standard","2022-05-15T00:00:00.000Z","[2318,449,1834,2321,966]","[2528,1081,3135,1964,274]","Breach,Sova,Killjoy,Omen,Jett","Sova,Omen,Jett,KAY/O,Chamber",1588
64621,29004,"VCT EMEA 2022 - Stage 2 Challengers - Group Stage","Ascent",386,"Guild Esports",6656,"M3 Champions",2,13,9,8,4,2,1,1,5,5,8,4,0,0,0,4,8,5,5,"standard","2022-05-15T00:00:00.000Z","[449,966,2321,1834,2318]","[2528,3135,1081,1964,274]","Sova,Killjoy,Omen,Jett,KAY/O","Sova,Jett,Astra,KAY/O,Chamber",1588
64138,28809,"VCT Brazil 2022 - Stage 2 Challengers 1 - Group Stage","Icebox",5748,"Los Grandes",580,"Gamelanders Blue",2,13,10,9,3,2,1,1,4,7,9,3,0,0,0,3,9,7,4,"standard","2022-05-15T00:00:00.000Z","[4770,6231,2103,669,2420]","[4747,739,1427,1113,6038]","Sova,Viper,Sage,Chamber,Fade","Sova,Viper,Sage,KAY/O,Chamber",1588
64640,29010,"VCT North America 2022 - Stage 2 Challengers - Group Stage","Fracture",603,"XSET",978,"Ghost Gaming",2,13,9,7,5,1,1,0,6,4,7,5,1,1,0,5,7,4,6,"standard","2022-05-14T00:00:00.000Z","[494,3582,3062,3346,1802]","[1468,1780,3074,1578,3016]","Breach,Raze,Brimstone,Sage,Chamber","Breach,Raze,Brimstone,Sage,Chamber",1588
64137,28809,"VCT Brazil 2022 - Stage 2 Challengers 1 - Group Stage","Split",5748,"Los Grandes",580,"Gamelanders Blue",1,13,10,5,7,1,0,1,5,7,8,3,1,0,1,3,8,7,5,"standard","2022-05-14T00:00:00.000Z","[6231,4770,2103,669,2420]","[4747,739,1427,6038,1113]","Breach,Raze,Astra,Chamber,Fade","Raze,Viper,Omen,Chamber,Fade",1588
64319,28866,"VCT LATAM South 2022 - Stage 2 Challengers - Group Stage","Icebox",1503,"Movistar Optix",683,"9z Team",2,13,10,3,9,1,1,0,10,1,3,9,1,1,0,9,3,1,10,"standard","2022-05-14T00:00:00.000Z","[1579,3411,3409,14764,14762]","[9905,1376,3506,3510,855]","Sova,Viper,Sage,Reyna,Chamber","Sova,Viper,Sage,Jett,Chamber",1588
64639,29010,"VCT North America 2022 - Stage 2 Challengers - Group Stage","Haven",603,"XSET",978,"Ghost Gaming",1,13,11,8,4,2,1,1,8,4,5,7,0,0,0,7,5,4,8,"standard","2022-05-14T00:00:00.000Z","[494,3062,3582,3346,1802]","[1468,3074,3016,1780,1578]","Breach,Omen,Jett,Skye,Chamber","Breach,Omen,Jett,KAY/O,Chamber",1588
64136,28809,"VCT Brazil 2022 - Stage 2 Challengers 1 - Group Stage","Breeze",5748,"Los Grandes",580,"Gamelanders Blue",2,6,13,3,9,0,0,0,3,4,3,9,2,1,1,9,3,4,3,"standard","2022-05-14T00:00:00.000Z","[2103,6231,2420,669,4770]","[739,4747,1427,1113,6038]","Sova,Viper,KAY/O,Chamber,Fade","Cypher,Sova,Viper,KAY/O,Neon",1588
64318,28866,"VCT LATAM South 2022 - Stage 2 Challengers - Group Stage","Ascent",1503,"Movistar Optix",683,"9z Team",2,7,13,5,7,2,1,1,2,6,5,7,0,0,0,7,5,6,2,"standard","2022-05-14T00:00:00.000Z","[3409,1579,14764,3411,14762]","[9905,855,1376,3510,3506]","Sova,Killjoy,Jett,Astra,KAY/O","Sova,Sage,Omen,KAY/O,Chamber",1588
64134,28808,"VCT Brazil 2022 - Stage 2 Challengers 1 - Group Stage","Breeze",6344,"LOUD",1264,"FURIA",2,13,4,9,3,1,0,1,4,1,9,3,1,0,1,3,9,1,4,"standard","2022-05-14T00:00:00.000Z","[2294,6037,4748,2895,4746]","[18192,2749,6039,2752,2423]","Sova,Viper,Jett,KAY/O,Chamber","Sova,Viper,Jett,KAY/O,Chamber",1588
64643,29011,"VCT North America 2022 - Stage 2 Challengers - Group Stage","Fracture",6426,"OpTic Gaming",617,"FaZe Clan",1,13,9,5,7,2,1,1,5,7,8,2,0,0,0,2,8,7,5,"standard","2022-05-14T00:00:00.000Z","[2841,398,2483,2716,3211]","[394,369,1994,789,1990]","Breach,Brimstone,KAY/O,Chamber,Neon","Breach,Raze,Brimstone,Chamber,Fade",1588
64317,28866,"VCT LATAM South 2022 - Stage 2 Challengers - Group Stage","Bind",1503,"Movistar Optix",683,"9z Team",1,13,7,9,3,2,1,1,9,3,4,4,0,0,0,4,4,3,9,"standard","2022-05-14T00:00:00.000Z","[14764,3409,3411,14762,1579]","[9905,855,1376,3510,3506]","Raze,Viper,Brimstone,Skye,Chamber","Breach,Raze,Brimstone,Skye,Chamber",1588
64133,28808,"VCT Brazil 2022 - Stage 2 Challengers 1 - Group Stage","Ascent",6344,"LOUD",1264,"FURIA",2,13,3,9,3,2,1,1,4,0,9,3,0,0,0,3,9,0,4,"standard","2022-05-14T00:00:00.000Z","[2294,4746,6037,4748,2895]","[6039,18192,2749,2752,2423]","Sova,Killjoy,Omen,Jett,KAY/O","Raze,Sova,Omen,KAY/O,Chamber",1588
64315,28865,"VCT LATAM South 2022 - Stage 2 Challengers - Group Stage","Bind",7014,"SunXet Club",976,"KRÜ Esports",1,0,13,0,12,0,0,0,0,12,0,1,2,1,1,1,0,12,0,"standard","2022-05-14T00:00:00.000Z","[3504,3503,3458,5907,3719]","[1725,4712,3535,4710,2532]","Raze,Viper,Brimstone,Skye,Chamber","Raze,Viper,Brimstone,Skye,Chamber",1588
64642,29011,"VCT North America 2022 - Stage 2 Challengers - Group Stage","Ascent",6426,"OpTic Gaming",617,"FaZe Clan",2,13,8,9,3,2,1,1,4,5,9,3,0,0,0,3,9,5,4,"standard","2022-05-14T00:00:00.000Z","[2841,398,2483,2716,3211]","[394,369,1990,1994,789]","Breach,Omen,KAY/O,Chamber,Neon","Sova,Jett,Skye,Astra,Chamber",1588
64314,28865,"VCT LATAM South 2022 - Stage 2 Challengers - Group Stage","Breeze",7014,"SunXet Club",976,"KRÜ Esports",2,11,13,6,6,1,1,0,5,7,6,6,1,1,0,6,6,7,5,"standard","2022-05-14T00:00:00.000Z","[3504,5907,3458,3503,3719]","[4712,3535,4710,2532,1725]","Sova,Viper,Astra,KAY/O,Chamber","Sova,Viper,KAY/O,Chamber,Neon",1588
64616,29002,"VCT EMEA 2022 - Stage 2 Challengers - Group Stage","Split",224,"Team Liquid",329,"BIG",1,13,7,7,5,2,1,1,7,5,6,2,0,0,0,2,6,5,7,"standard","2022-05-14T00:00:00.000Z","[1403,1690,17788,10211,2056]","[1828,1538,360,2326,819]","Breach,Raze,Cypher,Omen,Astra","Breach,Raze,Omen,Chamber,Fade",1588
64615,29002,"VCT EMEA 2022 - Stage 2 Challengers - Group Stage","Icebox",224,"Team Liquid",329,"BIG",2,13,5,9,3,1,0,1,4,2,9,3,1,0,1,3,9,2,4,"standard","2022-05-14T00:00:00.000Z","[1690,17788,1403,10211,2056]","[1828,2326,819,1538,360]","Raze,Viper,Sage,Omen,Fade","Sova,Viper,Omen,Jett,Chamber",1588
64614,29001,"VCT EMEA 2022 - Stage 2 Challengers - Group Stage","Icebox",1625,"FNATIC",17,"FunPlus Phoenix",2,13,10,6,6,2,1,1,7,4,6,6,0,0,0,6,6,4,7,"standard","2022-05-14T00:00:00.000Z","[718,14543,2011,76,2937]","[2225,2359,1256,3043,2335]","Sova,Killjoy,Viper,Sage,Chamber","Viper,Sage,KAY/O,Chamber,Fade",1588
64613,29001,"VCT EMEA 2022 - Stage 2 Challengers - Group Stage","Ascent",1625,"FNATIC",17,"FunPlus Phoenix",2,5,13,4,8,1,1,0,1,5,4,8,1,1,0,8,4,5,1,"standard","2022-05-14T00:00:00.000Z","[14543,2011,76,2937,718]","[2225,2335,1256,3043,2359]","Raze,Omen,KAY/O,Chamber,Fade","Sage,Omen,KAY/O,Chamber,Fade",1588
64612,29001,"VCT EMEA 2022 - Stage 2 Challengers - Group Stage","Fracture",1625,"FNATIC",17,"FunPlus Phoenix",2,13,3,9,3,2,1,1,4,0,9,3,0,0,0,3,9,0,4,"standard","2022-05-14T00:00:00.000Z","[76,14543,718,2011,2937]","[3043,1256,2225,2335,2359]","Breach,Raze,Viper,Astra,Chamber","Breach,Raze,Cypher,Yoru,Astra",1588
64638,29009,"VCT North America 2022 - Stage 2 Challengers - Group Stage","Fracture",279,"Luminosity Gaming",388,"Sentinels",1,13,4,8,4,1,0,1,8,4,5,0,1,0,1,0,5,4,8,"standard","2022-05-14T00:00:00.000Z","[2489,1801,3345,1522,905]","[893,3033,724,1614,1249]","Breach,Raze,Brimstone,KAY/O,Chamber","Breach,Raze,Sage,Astra,Chamber",1588
64637,29009,"VCT North America 2022 - Stage 2 Challengers - Group Stage","Breeze",279,"Luminosity Gaming",388,"Sentinels",1,14,16,4,8,1,0,1,5,10,9,6,1,0,1,6,9,10,5,"standard","2022-05-13T00:00:00.000Z","[3345,2489,1522,905,1801]","[724,893,1614,3033,1249]","Cypher,Sova,Viper,Jett,Skye","Cypher,Sova,Viper,Jett,KAY/O",1588
64636,29009,"VCT North America 2022 - Stage 2 Challengers - Group Stage","Bind",279,"Luminosity Gaming",388,"Sentinels",2,13,11,7,5,0,0,0,6,6,7,5,2,1,1,5,7,6,6,"standard","2022-05-13T00:00:00.000Z","[1801,3345,1522,2489,905]","[893,724,1614,3033,1249]","Raze,Viper,Brimstone,Skye,Chamber","Sova,Viper,Omen,Jett,Skye",1588
64634,29008,"VCT North America 2022 - Stage 2 Challengers - Group Stage","Bind",5201,"The Guard",305,"100 Thieves",1,6,13,6,6,0,0,0,6,6,0,7,2,1,1,7,0,6,6,"standard","2022-05-13T00:00:00.000Z","[1091,4141,1804,11412,2551]","[2354,122,1012,269,763]","Raze,Viper,Brimstone,Skye,Chamber","Raze,Viper,Brimstone,Sage,Skye",1588
64633,29008,"VCT North America 2022 - Stage 2 Challengers - Group Stage","Fracture",5201,"The Guard",305,"100 Thieves",2,5,13,2,10,0,0,0,3,3,2,10,2,1,1,10,2,3,3,"standard","2022-05-13T00:00:00.000Z","[11412,1091,4141,1804,2551]","[269,763,1012,122,2354]","Breach,Raze,Viper,Brimstone,Chamber","Breach,Raze,Brimstone,Sage,Chamber",1588
64607,28999,"VCT EMEA 2022 - Stage 2 Challengers - Group Stage","Split",7050,"OG LDN UTD",2597,"Acend",2,12,14,8,4,2,1,1,4,9,8,5,0,0,0,5,8,9,4,"standard","2022-05-13T00:00:00.000Z","[426,2561,2199,2305,1894]","[2391,1268,87,691,732]","Breach,Raze,Sage,Omen,Chamber","Raze,Cypher,Sage,Omen,Jett",1588
64606,28999,"VCT EMEA 2022 - Stage 2 Challengers - Group Stage","Icebox",7050,"OG LDN UTD",2597,"Acend",2,7,13,4,8,2,1,1,3,5,4,8,0,0,0,8,4,5,3,"standard","2022-05-13T00:00:00.000Z","[2561,2199,2305,1894,426]","[87,1268,732,2391,691]","Sova,Viper,Sage,Chamber,Fade","Sova,Viper,Reyna,KAY/O,Chamber",1588
64611,29000,"VCT EMEA 2022 - Stage 2 Challengers - Group Stage","Fracture",520,"BBL Esports",4220,"Natus Vincere",1,13,6,10,2,1,1,0,10,2,3,4,1,1,0,4,3,2,10,"standard","2022-05-13T00:00:00.000Z","[1749,3152,2864,1852,9643]","[491,999,3003,2279,2983]","Breach,Brimstone,Sage,Chamber,Neon","Breach,Raze,Brimstone,Chamber,Neon",1588
64610,29000,"VCT EMEA 2022 - Stage 2 Challengers - Group Stage","Icebox",520,"BBL Esports",4220,"Natus Vincere",1,18,16,5,7,0,0,0,9,8,9,8,2,1,1,8,9,8,9,"standard","2022-05-13T00:00:00.000Z","[2864,3152,1749,1852,9643]","[3003,491,2279,2983,999]","Sova,Viper,Sage,KAY/O,Chamber","Sova,Viper,Sage,KAY/O,Chamber",1588
64609,29000,"VCT EMEA 2022 - Stage 2 Challengers - Group Stage","Ascent",520,"BBL Esports",4220,"Natus Vincere",2,6,13,3,9,1,1,0,3,4,3,9,1,1,0,9,3,4,3,"standard","2022-05-13T00:00:00.000Z","[2864,1749,3152,1852,9643]","[2983,2279,491,999,3003]","Sova,Sage,Astra,KAY/O,Chamber","Sova,Killjoy,Omen,Jett,KAY/O",1588
61701,27670,"Valorant Champions Tour 2022: Stage 1 Masters - Reykjavík - Playoffs","Breeze",6344,"LOUD",6426,"OpTic Gaming",2,13,15,4,8,1,1,0,9,5,4,10,1,1,0,10,4,5,9,"standard","2022-04-24T00:00:00.000Z","[2294,4746,4748,2895,6037]","[2483,2841,2716,3211,398]","Sova,Viper,Jett,KAY/O,Chamber","Sova,Viper,Jett,KAY/O,Chamber",1588
61700,27670,"Valorant Champions Tour 2022: Stage 1 Masters - Reykjavík - Playoffs","Bind",6344,"LOUD",6426,"OpTic Gaming",1,12,14,4,8,2,1,1,4,9,8,5,0,0,0,5,8,9,4,"standard","2022-04-24T00:00:00.000Z","[4748,2294,4746,2895,6037]","[3211,2841,398,2483,2716]","Raze,Sova,Viper,Skye,Astra","Raze,Viper,Brimstone,Skye,Chamber",1588
61699,27670,"Valorant Champions Tour 2022: Stage 1 Masters - Reykjavík - Playoffs","Ascent",6344,"LOUD",6426,"OpTic Gaming",1,9,13,2,10,1,0,1,2,10,7,3,1,0,1,3,7,10,2,"standard","2022-04-24T00:00:00.000Z","[2294,4746,6037,4748,2895]","[2483,2841,398,2716,3211]","Sova,Killjoy,Omen,Jett,KAY/O","Sova,Killjoy,Omen,Jett,KAY/O",1588
61696,27669,"Valorant Champions Tour 2022: Stage 1 Masters - Reykjavík - Playoffs","Bind",6426,"OpTic Gaming",611,"ZETA DIVISION",1,13,8,8,4,2,1,1,8,4,5,4,0,0,0,4,5,4,8,"standard","2022-04-23T00:00:00.000Z","[3211,2841,398,2483,2716]","[519,2212,1593,2699,2232]","Raze,Viper,Brimstone,Skye,Chamber","Raze,Viper,Sage,Skye,Astra",1588
61695,27669,"Valorant Champions Tour 2022: Stage 1 Masters - Reykjavík - Playoffs","Fracture",6426,"OpTic Gaming",611,"ZETA DIVISION",2,13,5,7,5,1,1,0,6,0,7,5,1,1,0,5,7,0,6,"standard","2022-04-23T00:00:00.000Z","[2841,398,2483,2716,3211]","[2699,519,1593,2232,2212]","Breach,Brimstone,KAY/O,Chamber,Neon","Breach,Raze,Viper,Astra,Chamber",1588
61694,27669,"Valorant Champions Tour 2022: Stage 1 Masters - Reykjavík - Playoffs","Haven",6426,"OpTic Gaming",611,"ZETA DIVISION",2,15,13,5,7,0,0,0,8,6,7,7,2,1,1,7,7,6,8,"standard","2022-04-23T00:00:00.000Z","[398,2483,2841,2716,3211]","[2699,2212,1593,519,2232]","Omen,Skye,KAY/O,Chamber,Neon","Breach,Killjoy,Jett,Skye,Astra",1588
61339,27456,"Valorant Champions Tour 2022: Stage 1 Masters - Reykjavík - Playoffs","Split",611,"ZETA DIVISION",184,"Paper Rex",2,13,10,6,6,0,0,0,7,4,6,6,2,1,1,6,6,4,7,"standard","2022-04-22T00:00:00.000Z","[519,2212,1593,2699,2232]","[432,8387,8388,8385,8386]","Raze,Viper,Sage,Skye,Astra","Raze,Cypher,Sage,Omen,Jett",1588
61338,27456,"Valorant Champions Tour 2022: Stage 1 Masters - Reykjavík - Playoffs","Haven",611,"ZETA DIVISION",184,"Paper Rex",2,13,2,10,2,2,1,1,3,0,10,2,0,0,0,2,10,0,3,"standard","2022-04-22T00:00:00.000Z","[2699,2212,1593,519,2232]","[8387,432,8385,8386,8388]","Breach,Killjoy,Jett,Skye,Astra","Cypher,Reyna,Omen,Jett,Skye",1588
61337,27456,"Valorant Champions Tour 2022: Stage 1 Masters - Reykjavík - Playoffs","Icebox",611,"ZETA DIVISION",184,"Paper Rex",2,6,13,4,8,0,0,0,2,5,4,8,2,1,1,8,4,5,2,"standard","2022-04-22T00:00:00.000Z","[2699,2232,519,1593,2212]","[8387,8385,432,8386,8388]","Sova,Viper,Sage,Jett,Chamber","Sova,Viper,Sage,Jett,Chamber",1588
61280,27431,"Valorant Champions Tour 2022: Stage 1 Masters - Reykjavík - Playoffs","Icebox",6344,"LOUD",6426,"OpTic Gaming",1,13,11,7,5,2,1,1,7,5,6,6,0,0,0,6,6,5,7,"standard","2022-04-22T00:00:00.000Z","[2294,4746,6037,4748,2895]","[2483,398,2841,3211,2716]","Sova,Viper,Sage,Jett,Chamber","Sova,Viper,Sage,KAY/O,Chamber",1588
61279,27431,"Valorant Champions Tour 2022: Stage 1 Masters - Reykjavík - Playoffs","Ascent",6344,"LOUD",6426,"OpTic Gaming",1,13,8,5,7,2,1,1,5,7,8,1,0,0,0,1,8,7,5,"standard","2022-04-22T00:00:00.000Z","[2294,4746,6037,4748,2895]","[2483,2841,398,2716,3211]","Sova,Killjoy,Omen,Jett,KAY/O","Sova,Killjoy,Omen,Jett,KAY/O",1588
61278,27431,"Valorant Champions Tour 2022: Stage 1 Masters - Reykjavík - Playoffs","Fracture",6344,"LOUD",6426,"OpTic Gaming",2,2,13,2,10,0,0,0,0,3,2,10,2,1,1,10,2,3,0,"standard","2022-04-22T00:00:00.000Z","[2294,4748,4746,6037,2895]","[2841,398,2483,2716,3211]","Breach,Raze,Viper,Brimstone,Chamber","Breach,Brimstone,KAY/O,Chamber,Neon",1588
61184,27374,"Valorant Champions Tour 2022: Stage 1 Masters - Reykjavík - Playoffs","Bind",194,"G2 Esports (Inactive)",184,"Paper Rex",2,7,13,4,8,1,1,0,3,5,4,8,1,1,0,8,4,5,3,"standard","2022-04-18T00:00:00.000Z","[1826,2377,2769,2594,2940]","[8387,432,8385,8388,8386]","Raze,Viper,Omen,Skye,Chamber","Breach,Raze,Brimstone,Skye,Yoru",1588
61183,27374,"Valorant Champions Tour 2022: Stage 1 Masters - Reykjavík - Playoffs","Split",194,"G2 Esports (Inactive)",184,"Paper Rex",2,10,13,9,3,1,0,1,1,10,9,3,1,0,1,3,9,10,1,"standard","2022-04-18T00:00:00.000Z","[2377,1826,2594,2769,2940]","[432,8387,8388,8385,8386]","Breach,Raze,Sage,Omen,Chamber","Raze,Cypher,Sage,Omen,Jett",1588
61182,27373,"Valorant Champions Tour 2022: Stage 1 Masters - Reykjavík - Playoffs","Split",286,"DRX",611,"ZETA DIVISION",1,4,13,2,10,0,0,0,2,10,2,3,2,1,1,3,2,10,2,"standard","2022-04-18T00:00:00.000Z","[452,814,1550,582,1251]","[519,2212,1593,2699,2232]","Viper,Sage,Jett,Skye,Astra","Raze,Viper,Sage,Skye,Astra",1588
61181,27373,"Valorant Champions Tour 2022: Stage 1 Masters - Reykjavík - Playoffs","Ascent",286,"DRX",611,"ZETA DIVISION",1,13,10,7,5,1,1,0,7,5,6,5,1,1,0,5,6,5,7,"standard","2022-04-18T00:00:00.000Z","[814,1550,582,452,1251]","[2699,519,1593,2232,2212]","Sova,Jett,Skye,Astra,Chamber","Sova,Killjoy,Jett,Astra,Chamber",1588
61180,27373,"Valorant Champions Tour 2022: Stage 1 Masters - Reykjavík - Playoffs","Icebox",286,"DRX",611,"ZETA DIVISION",1,11,13,4,8,2,1,1,4,8,7,5,0,0,0,5,7,8,4,"standard","2022-04-18T00:00:00.000Z","[814,452,1550,1251,582]","[2699,2232,519,1593,2212]","Sova,Viper,Sage,Jett,KAY/O","Sova,Viper,Sage,Jett,Chamber",1588
61089,27323,"Valorant Champions Tour 2022: Stage 1 Masters - Reykjavík - Playoffs","Breeze",194,"G2 Esports (Inactive)",6344,"LOUD",2,11,13,4,8,1,0,1,7,5,4,8,1,0,1,8,4,5,7,"standard","2022-04-17T00:00:00.000Z","[2594,2377,1826,2769,2940]","[2294,4746,4748,2895,6037]","Sova,Viper,Jett,KAY/O,Chamber","Sova,Viper,Jett,KAY/O,Chamber",1588
61088,27323,"Valorant Champions Tour 2022: Stage 1 Masters - Reykjavík - Playoffs","Ascent",194,"G2 Esports (Inactive)",6344,"LOUD",2,5,13,3,9,1,1,0,2,4,3,9,1,1,0,9,3,4,2,"standard","2022-04-17T00:00:00.000Z","[2377,1826,2594,2769,2940]","[2294,4746,6037,4748,2895]","Cypher,Sova,Sage,Omen,Jett","Sova,Killjoy,Omen,Jett,KAY/O",1588
61132,27339,"Valorant Champions Tour 2022: Stage 1 Masters - Reykjavík - Playoffs","Split",286,"DRX",6426,"OpTic Gaming",1,13,15,6,6,1,1,0,6,8,7,7,1,1,0,7,7,8,6,"standard","2022-04-17T00:00:00.000Z","[452,814,1550,582,1251]","[2841,398,2483,2716,3211]","Viper,Sage,Jett,Skye,Astra","Breach,Astra,KAY/O,Chamber,Neon",1588
61131,27339,"Valorant Champions Tour 2022: Stage 1 Masters - Reykjavík - Playoffs","Icebox",286,"DRX",6426,"OpTic Gaming",1,11,13,7,5,1,0,1,7,5,4,8,1,0,1,8,4,5,7,"standard","2022-04-17T00:00:00.000Z","[814,452,1550,1251,582]","[2483,398,2841,3211,2716]","Sova,Viper,Sage,Jett,KAY/O","Sova,Viper,Sage,KAY/O,Chamber",1588
61130,27339,"Valorant Champions Tour 2022: Stage 1 Masters - Reykjavík - Playoffs","Ascent",286,"DRX",6426,"OpTic Gaming",1,13,8,9,3,2,1,1,9,3,4,5,0,0,0,5,4,3,9,"standard","2022-04-17T00:00:00.000Z","[814,1550,582,452,1251]","[2483,2841,398,2716,3211]","Sova,Jett,Skye,Astra,Chamber","Sova,Killjoy,Omen,Jett,KAY/O",1588
61134,27340,"Valorant Champions Tour 2022: Stage 1 Masters - Reykjavík - Playoffs","Split",184,"Paper Rex",5201,"The Guard",1,13,8,6,6,1,1,0,6,6,7,2,1,1,0,2,7,6,6,"standard","2022-04-16T00:00:00.000Z","[432,8387,8388,8385,8386]","[11412,2551,4141,1091,1804]","Raze,Cypher,Sage,Omen,Jett","Breach,Raze,Cypher,Sage,Omen",1588
61133,27340,"Valorant Champions Tour 2022: Stage 1 Masters - Reykjavík - Playoffs","Haven",184,"Paper Rex",5201,"The Guard",1,13,10,8,4,2,1,1,8,4,5,6,0,0,0,6,5,4,8,"standard","2022-04-16T00:00:00.000Z","[8387,432,8385,8386,8388]","[1091,4141,1804,2551,11412]","Cypher,Reyna,Omen,Jett,Skye","Breach,Killjoy,Omen,Jett,Skye",1588
61093,27324,"Valorant Champions Tour 2022: Stage 1 Masters - Reykjavík - Playoffs","Split",611,"ZETA DIVISION",224,"Team Liquid",2,13,7,6,6,2,1,1,7,1,6,6,0,0,0,6,6,1,7,"standard","2022-04-16T00:00:00.000Z","[519,2212,1593,2699,2232]","[10211,2056,17788,1690,1403]","Raze,Viper,Sage,Skye,Astra","Breach,Raze,Cypher,Sage,Astra",1588
61092,27324,"Valorant Champions Tour 2022: Stage 1 Masters - Reykjavík - Playoffs","Haven",611,"ZETA DIVISION",224,"Team Liquid",2,4,13,2,10,1,1,0,2,3,2,10,1,1,0,10,2,3,2,"standard","2022-04-16T00:00:00.000Z","[2699,2212,1593,519,2232]","[10211,1403,1690,2056,17788]","Breach,Killjoy,Jett,Skye,Astra","Breach,Omen,Jett,Skye,Chamber",1588
61091,27324,"Valorant Champions Tour 2022: Stage 1 Masters - Reykjavík - Playoffs","Fracture",611,"ZETA DIVISION",224,"Team Liquid",2,13,7,10,2,1,0,1,3,5,10,2,1,0,1,2,10,5,3,"standard","2022-04-16T00:00:00.000Z","[2699,519,1593,2232,2212]","[10211,1403,1690,17788,2056]","Breach,Raze,Viper,Astra,Chamber","Breach,Brimstone,Jett,Chamber,Neon",1588
61029,27292,"Valorant Champions Tour 2022: Stage 1 Masters - Reykjavík - Playoffs","Fracture",5201,"The Guard",6426,"OpTic Gaming",2,11,13,8,4,2,1,1,3,9,8,4,0,0,0,4,8,9,3,"standard","2022-04-15T00:00:00.000Z","[11412,1091,1804,2551,4141]","[2841,398,2483,2716,3211]","Breach,Viper,Brimstone,Jett,Chamber","Breach,Brimstone,KAY/O,Chamber,Neon",1588
61028,27292,"Valorant Champions Tour 2022: Stage 1 Masters - Reykjavík - Playoffs","Haven",5201,"The Guard",6426,"OpTic Gaming",1,13,7,7,5,2,1,1,7,5,6,2,0,0,0,2,6,5,7,"standard","2022-04-15T00:00:00.000Z","[1091,1804,2551,11412,4141]","[398,2483,2841,2716,3211]","Breach,Omen,Jett,Skye,Chamber","Omen,Skye,KAY/O,Chamber,Neon",1588
61027,27292,"Valorant Champions Tour 2022: Stage 1 Masters - Reykjavík - Playoffs","Icebox",5201,"The Guard",6426,"OpTic Gaming",1,7,13,3,9,1,0,1,3,9,4,4,1,0,1,4,4,9,3,"standard","2022-04-15T00:00:00.000Z","[11412,1804,1091,2551,4141]","[2483,398,2841,3211,2716]","Sova,Viper,Omen,Jett,Chamber","Sova,Viper,Sage,KAY/O,Chamber",1588
61026,27291,"Valorant Champions Tour 2022: Stage 1 Masters - Reykjavík - Playoffs","Ascent",184,"Paper Rex",286,"DRX",2,8,13,3,9,0,0,0,5,4,3,9,2,1,1,9,3,4,5,"standard","2022-04-15T00:00:00.000Z","[8387,8388,8385,8386,432]","[814,1550,582,452,1251]","Sova,Killjoy,Omen,Jett,KAY/O","Sova,Jett,Skye,Astra,Chamber",1588
61025,27291,"Valorant Champions Tour 2022: Stage 1 Masters - Reykjavík - Playoffs","Bind",184,"Paper Rex",286,"DRX",2,8,13,3,9,1,0,1,5,4,3,9,1,0,1,9,3,4,5,"standard","2022-04-15T00:00:00.000Z","[8387,432,8385,8388,8386]","[1550,452,814,582,1251]","Breach,Raze,Brimstone,Skye,Yoru","Raze,Viper,Sage,Skye,Astra",1588
61024,27291,"Valorant Champions Tour 2022: Stage 1 Masters - Reykjavík - Playoffs","Haven",184,"Paper Rex",286,"DRX",1,13,10,4,8,2,1,1,4,8,9,2,0,0,0,2,9,8,4,"standard","2022-04-15T00:00:00.000Z","[8387,8388,432,8385,8386]","[582,814,1251,452,1550]","Cypher,Sova,Reyna,Omen,Jett","Breach,Sova,Killjoy,Omen,Jett",1588
61023,27290,"Valorant Champions Tour 2022: Stage 1 Masters - Reykjavík - Playoffs","Ascent",6344,"LOUD",224,"Team Liquid",1,13,10,6,6,1,0,1,6,6,7,4,1,0,1,4,7,6,6,"standard","2022-04-14T00:00:00.000Z","[2294,4746,6037,4748,2895]","[2056,17788,1403,10211,1690]","Sova,Killjoy,Omen,Jett,KAY/O","Sova,Killjoy,Omen,Jett,KAY/O",1588
61022,27290,"Valorant Champions Tour 2022: Stage 1 Masters - Reykjavík - Playoffs","Haven",6344,"LOUD",224,"Team Liquid",1,3,13,2,10,0,0,0,2,10,1,3,2,1,1,3,1,10,2,"standard","2022-04-14T00:00:00.000Z","[2895,2294,4746,6037,4748]","[10211,1403,1690,2056,17788]","Breach,Sova,Killjoy,Omen,Jett","Breach,Omen,Jett,Skye,Chamber",1588
61021,27290,"Valorant Champions Tour 2022: Stage 1 Masters - Reykjavík - Playoffs","Icebox",6344,"LOUD",224,"Team Liquid",1,13,10,7,5,0,0,0,7,5,6,5,2,1,1,5,6,5,7,"standard","2022-04-14T00:00:00.000Z","[2294,4746,6037,4748,2895]","[10211,17788,1403,2056,1690]","Sova,Viper,Sage,Jett,Chamber","Sova,Killjoy,Viper,Sage,Jett",1588
61019,27289,"Valorant Champions Tour 2022: Stage 1 Masters - Reykjavík - Playoffs","Bind",194,"G2 Esports (Inactive)",611,"ZETA DIVISION",1,13,10,5,7,2,1,1,5,7,8,3,0,0,0,3,8,7,5,"standard","2022-04-14T00:00:00.000Z","[1826,2377,2769,2594,2940]","[519,2212,1593,2699,2232]","Raze,Viper,Omen,Skye,Chamber","Raze,Viper,Sage,Skye,Astra",1588
61018,27289,"Valorant Champions Tour 2022: Stage 1 Masters - Reykjavík - Playoffs","Split",194,"G2 Esports (Inactive)",611,"ZETA DIVISION",2,13,7,7,5,1,1,0,6,2,7,5,1,1,0,5,7,2,6,"standard","2022-04-14T00:00:00.000Z","[2377,1826,2594,2769,2940]","[519,2212,1593,2699,2232]","Breach,Raze,Sage,Omen,Chamber","Raze,Viper,Sage,Skye,Astra",1588
60996,27281,"Valorant Champions Tour 2022: Stage 1 Masters - Reykjavík - Group Stage","Fracture",5750,"Ninjas in Pyjamas",611,"ZETA DIVISION",1,12,14,7,5,2,1,1,7,6,5,8,0,0,0,8,5,6,7,"standard","2022-04-13T00:00:00.000Z","[762,3408,2195,3203,16804]","[2699,519,1593,2232,2212]","Cypher,Brimstone,Sage,Jett,KAY/O","Breach,Raze,Viper,Astra,Chamber",1588
60995,27281,"Valorant Champions Tour 2022: Stage 1 Masters - Reykjavík - Group Stage","Icebox",5750,"Ninjas in Pyjamas",611,"ZETA DIVISION",1,10,13,4,8,0,0,0,4,8,6,5,2,1,1,5,6,8,4,"standard","2022-04-13T00:00:00.000Z","[16804,3408,762,2195,3203]","[2699,2232,519,1593,2212]","Sova,Viper,Sage,Reyna,Jett","Sova,Viper,Sage,Jett,Chamber",1588
60994,27281,"Valorant Champions Tour 2022: Stage 1 Masters - Reykjavík - Group Stage","Split",5750,"Ninjas in Pyjamas",611,"ZETA DIVISION",2,13,6,7,5,2,1,1,6,1,7,5,0,0,0,5,7,1,6,"standard","2022-04-13T00:00:00.000Z","[3203,762,16804,3408,2195]","[519,2212,1593,2699,2232]","Raze,Cypher,Sage,Omen,Jett","Raze,Viper,Sage,Skye,Astra",1588
60998,27282,"Valorant Champions Tour 2022: Stage 1 Masters - Reykjavík - Group Stage","Haven",5903,"XERXIA Esports",6426,"OpTic Gaming",2,6,13,3,9,1,1,0,3,4,3,9,1,1,0,9,3,4,3,"standard","2022-04-13T00:00:00.000Z","[3642,671,766,21245,6890]","[398,2483,2841,2716,3211]","Breach,Killjoy,Omen,Jett,Skye","Omen,Skye,KAY/O,Chamber,Neon",1588
60997,27282,"Valorant Champions Tour 2022: Stage 1 Masters - Reykjavík - Group Stage","Fracture",5903,"XERXIA Esports",6426,"OpTic Gaming",1,9,13,6,6,0,0,0,6,6,3,7,2,1,1,7,3,6,6,"standard","2022-04-13T00:00:00.000Z","[3642,671,6890,21245,766]","[2841,398,2483,2716,3211]","Breach,Cypher,Sage,Jett,Astra","Breach,Brimstone,KAY/O,Chamber,Neon",1588
60737,27143,"Valorant Champions Tour 2022: Stage 1 Masters - Reykjavík - Group Stage","Icebox",1625,"FNATIC",611,"ZETA DIVISION",1,11,13,6,6,1,0,1,6,6,5,7,1,0,1,7,5,6,6,"standard","2022-04-12T00:00:00.000Z","[718,76,154,2011,20]","[2699,2232,519,1593,2212]","Sova,Viper,Sage,KAY/O,Chamber","Sova,Viper,Sage,Jett,Chamber",1588
60736,27143,"Valorant Champions Tour 2022: Stage 1 Masters - Reykjavík - Group Stage","Fracture",1625,"FNATIC",611,"ZETA DIVISION",1,7,13,3,9,0,0,0,3,9,4,4,2,1,1,4,4,9,3,"standard","2022-04-12T00:00:00.000Z","[2011,20,154,718,76]","[2699,519,1593,2232,2212]","Breach,Raze,Cypher,Viper,Brimstone","Breach,Raze,Viper,Astra,Chamber",1588
60734,27142,"Valorant Champions Tour 2022: Stage 1 Masters - Reykjavík - Group Stage","Ascent",6426,"OpTic Gaming",976,"KRÜ Esports",1,13,10,5,7,1,0,1,5,7,8,3,1,0,1,3,8,7,5,"standard","2022-04-12T00:00:00.000Z","[2483,2841,398,2716,3211]","[4710,3535,2532,4712,1725]","Sova,Killjoy,Omen,Jett,KAY/O","Sova,Omen,Jett,KAY/O,Chamber",1588
60733,27142,"Valorant Champions Tour 2022: Stage 1 Masters - Reykjavík - Group Stage","Bind",6426,"OpTic Gaming",976,"KRÜ Esports",2,13,5,8,4,1,1,0,5,1,8,4,1,1,0,4,8,1,5,"standard","2022-04-12T00:00:00.000Z","[3211,2841,398,2483,2716]","[1725,4712,3535,2532,4710]","Raze,Viper,Brimstone,Skye,Chamber","Raze,Viper,Brimstone,Sage,Skye",1588
60740,27144,"Valorant Champions Tour 2022: Stage 1 Masters - Reykjavík - Group Stage","Breeze",5750,"Ninjas in Pyjamas",286,"DRX",2,8,13,5,7,2,1,1,3,6,5,7,0,0,0,7,5,6,3,"standard","2022-04-12T00:00:00.000Z","[16804,3408,2195,762,3203]","[814,452,1550,582,1251]","Sova,Viper,Jett,KAY/O,Chamber","Sova,Viper,Jett,Skye,Chamber",1588
60739,27144,"Valorant Champions Tour 2022: Stage 1 Masters - Reykjavík - Group Stage","Icebox",5750,"Ninjas in Pyjamas",286,"DRX",2,4,13,2,10,0,0,0,2,3,2,10,2,1,1,10,2,3,2,"standard","2022-04-12T00:00:00.000Z","[16804,3408,762,2195,3203]","[814,452,1550,1251,582]","Sova,Viper,Sage,Reyna,Jett","Sova,Viper,Sage,Jett,KAY/O",1588
60732,27141,"Valorant Champions Tour 2022: Stage 1 Masters - Reykjavík - Group Stage","Ascent",5903,"XERXIA Esports",224,"Team Liquid",1,15,17,7,5,1,0,1,9,7,6,10,1,0,1,10,6,7,9,"standard","2022-04-11T00:00:00.000Z","[6890,671,3642,766,21245]","[2056,17788,1403,10211,1690]","Sova,Killjoy,Sage,Omen,Jett","Sova,Killjoy,Omen,Jett,KAY/O",1588
60731,27141,"Valorant Champions Tour 2022: Stage 1 Masters - Reykjavík - Group Stage","Icebox",5903,"XERXIA Esports",224,"Team Liquid",2,13,11,6,6,1,0,1,7,5,6,6,1,0,1,6,6,5,7,"standard","2022-04-11T00:00:00.000Z","[6890,671,766,3642,21245]","[10211,17788,1403,2056,1690]","Sova,Killjoy,Viper,Sage,Jett","Sova,Killjoy,Viper,Sage,Jett",1588
60730,27141,"Valorant Champions Tour 2022: Stage 1 Masters - Reykjavík - Group Stage","Split",5903,"XERXIA Esports",224,"Team Liquid",2,7,13,6,6,2,1,1,1,7,6,6,0,0,0,6,6,7,1,"standard","2022-04-11T00:00:00.000Z","[3642,671,766,21245,6890]","[10211,2056,17788,1690,1403]","Breach,Killjoy,Omen,Jett,Skye","Breach,Raze,Cypher,Sage,Astra",1588
60198,26965,"Valorant Champions Tour 2022: Stage 1 Masters - Reykjavík - Group Stage","Split",1625,"FNATIC",5750,"Ninjas in Pyjamas",2,8,13,4,8,1,0,1,4,5,4,8,1,0,1,8,4,5,4,"standard","2022-04-11T00:00:00.000Z","[20,154,718,76,2011]","[3203,762,16804,3408,2195]","Raze,Viper,Sage,Omen,Skye","Raze,Cypher,Sage,Omen,Jett",1588
60197,26965,"Valorant Champions Tour 2022: Stage 1 Masters - Reykjavík - Group Stage","Ascent",1625,"FNATIC",5750,"Ninjas in Pyjamas",1,7,13,3,9,1,0,1,3,9,4,4,1,0,1,4,4,9,3,"standard","2022-04-11T00:00:00.000Z","[718,154,76,20,2011]","[16804,762,3408,2195,3203]","Sova,Killjoy,Omen,Jett,KAY/O","Sova,Killjoy,Omen,Jett,KAY/O",1588
60204,26967,"Valorant Champions Tour 2022: Stage 1 Masters - Reykjavík - Group Stage","Ascent",6426,"OpTic Gaming",5903,"XERXIA Esports",1,10,13,4,8,2,1,1,4,8,6,5,0,0,0,5,6,8,4,"standard","2022-04-10T00:00:00.000Z","[2483,2841,398,2716,3211]","[6890,671,3642,766,21245]","Sova,Killjoy,Brimstone,Jett,KAY/O","Sova,Killjoy,Sage,Omen,Jett",1588
60203,26967,"Valorant Champions Tour 2022: Stage 1 Masters - Reykjavík - Group Stage","Icebox",6426,"OpTic Gaming",5903,"XERXIA Esports",2,10,13,5,7,1,1,0,5,6,5,7,1,1,0,7,5,6,5,"standard","2022-04-10T00:00:00.000Z","[2483,398,2841,3211,2716]","[6890,671,766,3642,21245]","Sova,Viper,Sage,KAY/O,Chamber","Sova,Killjoy,Viper,Sage,Jett",1588
60207,26968,"Valorant Champions Tour 2022: Stage 1 Masters - Reykjavík - Group Stage","Ascent",976,"KRÜ Esports",224,"Team Liquid",2,14,16,6,6,2,1,1,7,8,7,8,0,0,0,8,7,8,7,"standard","2022-04-10T00:00:00.000Z","[4710,3535,2532,4712,1725]","[2056,17788,1403,10211,1690]","Sova,Omen,Jett,KAY/O,Chamber","Sova,Killjoy,Omen,Jett,KAY/O",1588
60206,26968,"Valorant Champions Tour 2022: Stage 1 Masters - Reykjavík - Group Stage","Fracture",976,"KRÜ Esports",224,"Team Liquid",2,5,13,5,7,1,0,1,0,6,5,7,1,0,1,7,5,6,0,"standard","2022-04-10T00:00:00.000Z","[4712,3535,4710,1725,2532]","[10211,1403,1690,17788,2056]","Breach,Brimstone,Sage,Jett,Chamber","Breach,Brimstone,Jett,Chamber,Neon",1588
60201,26966,"Valorant Champions Tour 2022: Stage 1 Masters - Reykjavík - Group Stage","Haven",286,"DRX",611,"ZETA DIVISION",1,13,3,11,1,1,0,1,11,1,2,2,1,0,1,2,2,1,11,"standard","2022-04-10T00:00:00.000Z","[582,814,1251,452,1550]","[2699,2212,1593,519,2232]","Breach,Sova,Killjoy,Omen,Jett","Breach,Killjoy,Jett,Skye,Astra",1588
60200,26966,"Valorant Champions Tour 2022: Stage 1 Masters - Reykjavík - Group Stage","Icebox",286,"DRX",611,"ZETA DIVISION",1,13,2,10,2,2,1,1,10,2,3,0,0,0,0,0,3,2,10,"standard","2022-04-10T00:00:00.000Z","[814,452,1550,1251,582]","[2699,2232,519,1593,2212]","Sova,Viper,Sage,Jett,KAY/O","Sova,Viper,Sage,Jett,Chamber",1588
59446,26700,"VCT South America 2022 - Stage 1: Last Chance Qualifier","Split",5750,"Ninjas in Pyjamas",738,"Leviatán",1,14,12,7,5,0,0,0,8,5,6,7,2,1,1,7,6,5,8,"standard","2022-04-01T00:00:00.000Z","[3203,762,16804,3408,2195]","[6414,3555,3531,3421,3532]","Raze,Cypher,Sage,Omen,Jett","Raze,Cypher,Sage,Omen,Jett",1588
59445,26700,"VCT South America 2022 - Stage 1: Last Chance Qualifier","Haven",5750,"Ninjas in Pyjamas",738,"Leviatán",1,13,6,6,6,1,0,1,6,6,7,0,1,0,1,0,7,6,6,"standard","2022-04-01T00:00:00.000Z","[762,16804,3408,3203,2195]","[6414,3531,3555,3421,3532]","Cypher,Sova,Omen,Jett,KAY/O","Breach,Sova,Killjoy,Omen,Jett",1588
59444,26700,"VCT South America 2022 - Stage 1: Last Chance Qualifier","Icebox",5750,"Ninjas in Pyjamas",738,"Leviatán",1,13,6,6,6,1,0,1,6,6,7,0,1,0,1,0,7,6,6,"standard","2022-04-01T00:00:00.000Z","[16804,3408,762,2195,3203]","[3531,3555,6414,3421,3532]","Sova,Viper,Sage,Reyna,Jett","Sova,Killjoy,Viper,Sage,Jett",1588
59358,26674,"VCT Latin America Stage 1 Stage 1: Playoffs","Split",738,"Leviatán",976,"KRÜ Esports",1,6,13,1,11,1,0,1,1,11,5,2,1,0,1,2,5,11,1,"standard","2022-03-29T00:00:00.000Z","[6414,3555,3531,3421,3532]","[1725,4712,4710,3535,2532]","Raze,Cypher,Sage,Omen,Jett","Raze,Cypher,Sage,Omen,Jett",1588
59357,26674,"VCT Latin America Stage 1 Stage 1: Playoffs","Fracture",738,"Leviatán",976,"KRÜ Esports",2,4,13,4,8,0,0,0,0,5,4,8,2,1,1,8,4,5,0,"standard","2022-03-28T00:00:00.000Z","[3531,6414,3555,3421,3532]","[4712,3535,4710,1725,2532]","Breach,Raze,Cypher,Brimstone,Jett","Breach,Brimstone,Sage,Jett,Chamber",1588
59356,26674,"VCT Latin America Stage 1 Stage 1: Playoffs","Ascent",738,"Leviatán",976,"KRÜ Esports",1,14,12,1,11,1,0,1,2,11,12,1,1,0,1,1,12,11,2,"standard","2022-03-28T00:00:00.000Z","[3531,3555,3421,3532,6414]","[4710,4712,3535,2532,1725]","Sova,Killjoy,Omen,Jett,KAY/O","Sova,Killjoy,Omen,Jett,KAY/O",1588
59355,26674,"VCT Latin America Stage 1 Stage 1: Playoffs","Haven",738,"Leviatán",976,"KRÜ Esports",2,13,9,6,6,1,0,1,7,3,6,6,1,0,1,6,6,3,7,"standard","2022-03-28T00:00:00.000Z","[6414,3531,3555,3421,3532]","[4712,4710,1725,3535,2532]","Breach,Sova,Killjoy,Omen,Jett","Cypher,Sova,Phoenix,Omen,Jett",1588
59354,26674,"VCT Latin America Stage 1 Stage 1: Playoffs","Breeze",738,"Leviatán",976,"KRÜ Esports",1,13,15,8,4,1,1,0,9,5,4,10,1,1,0,10,4,5,9,"standard","2022-03-28T00:00:00.000Z","[3531,3421,3532,6414,3555]","[4712,3535,1725,4710,2532]","Sova,Viper,Jett,KAY/O,Chamber","Sova,Viper,Jett,KAY/O,Chamber",1588
59340,26670,"VCT North America 2022 - Stage 1 Challengers - Main Event","Haven",6426,"OpTic Gaming",5201,"The Guard",1,11,13,8,4,2,1,1,8,4,3,9,0,0,0,9,3,4,8,"standard","2022-03-27T00:00:00.000Z","[2841,398,2483,2716,3211]","[1091,1804,2551,11412,4141]","Breach,Omen,Skye,Chamber,Neon","Breach,Omen,Jett,Skye,Chamber",1588
59339,26670,"VCT North America 2022 - Stage 1 Challengers - Main Event","Split",6426,"OpTic Gaming",5201,"The Guard",2,13,7,9,3,2,1,1,4,4,9,3,0,0,0,3,9,4,4,"standard","2022-03-27T00:00:00.000Z","[2841,398,2483,2716,3211]","[11412,2551,1804,1091,4141]","Breach,Astra,KAY/O,Chamber,Neon","Breach,Raze,Omen,Skye,Chamber",1588
59338,26670,"VCT North America 2022 - Stage 1 Challengers - Main Event","Breeze",6426,"OpTic Gaming",5201,"The Guard",1,2,13,2,10,0,0,0,2,10,0,3,2,1,1,3,0,10,2,"standard","2022-03-27T00:00:00.000Z","[2483,2841,2716,398,3211]","[11412,1804,2551,1091,4141]","Sova,Viper,Jett,Skye,Chamber","Sova,Viper,Jett,KAY/O,Chamber",1588
59337,26670,"VCT North America 2022 - Stage 1 Challengers - Main Event","Icebox",6426,"OpTic Gaming",5201,"The Guard",2,9,13,6,6,1,0,1,3,7,6,6,1,0,1,6,6,7,3,"standard","2022-03-27T00:00:00.000Z","[2483,398,2841,3211,2716]","[11412,1804,1091,2551,4141]","Sova,Viper,Sage,KAY/O,Chamber","Sova,Viper,Omen,Jett,Chamber",1588
59352,26673,"VCT Latin America Stage 1 Stage 1: Playoffs","Bind",553,"E-Xolos LAZER",976,"KRÜ Esports",2,8,13,7,5,0,0,0,1,8,7,5,2,1,1,5,7,8,1,"standard","2022-03-27T00:00:00.000Z","[1500,3274,3252,1141,2773]","[1725,4712,3535,2532,4710]","Raze,Sova,Brimstone,Skye,Chamber","Raze,Viper,Brimstone,Sage,Skye",1588
59351,26673,"VCT Latin America Stage 1 Stage 1: Playoffs","Haven",553,"E-Xolos LAZER",976,"KRÜ Esports",1,7,13,4,8,2,1,1,4,8,3,5,0,0,0,5,3,8,4,"standard","2022-03-27T00:00:00.000Z","[1500,1141,3252,3274,2773]","[4712,4710,1725,3535,2532]","Raze,Sova,Omen,KAY/O,Chamber","Cypher,Sova,Phoenix,Omen,Jett",1588
59336,26670,"VCT North America 2022 - Stage 1 Challengers - Main Event","Ascent",6426,"OpTic Gaming",5201,"The Guard",1,13,9,6,6,0,0,0,6,6,7,3,2,1,1,3,7,6,6,"standard","2022-03-27T00:00:00.000Z","[2483,2841,398,2716,3211]","[11412,4141,1804,2551,1091]","Sova,Killjoy,Brimstone,Jett,KAY/O","Sova,Killjoy,Omen,Jett,KAY/O",1588
59330,26668,"VCT Brazil 2022 - Stage 1 Challengers 1 - Playoffs","Ascent",6344,"LOUD",5750,"Ninjas in Pyjamas",2,13,4,8,4,2,1,1,5,0,8,4,0,0,0,4,8,0,5,"standard","2022-03-27T00:00:00.000Z","[2294,4746,6037,4748,2895]","[16804,762,2195,3408,3203]","Sova,Killjoy,Omen,Jett,KAY/O","Sova,Killjoy,Reyna,Omen,Jett",1588
59329,26668,"VCT Brazil 2022 - Stage 1 Challengers 1 - Playoffs","Fracture",6344,"LOUD",5750,"Ninjas in Pyjamas",1,13,11,8,4,0,0,0,8,4,5,7,2,1,1,7,5,4,8,"standard","2022-03-27T00:00:00.000Z","[2294,4748,4746,6037,2895]","[762,3408,2195,3203,16804]","Breach,Raze,Cypher,Brimstone,Chamber","Cypher,Brimstone,Sage,Jett,KAY/O",1588
59307,26662,"VCT EMEA 2022 - Stage 1 Challengers - Playoffs","Split",17,"FunPlus Phoenix",194,"G2 Esports (Inactive)",1,16,14,4,8,1,0,1,6,9,10,5,1,0,1,5,10,9,6,"standard","2022-03-27T00:00:00.000Z","[2335,1256,2225,2359,7705]","[2377,1826,2769,2594,2940]","Breach,Raze,Cypher,Sage,Omen","Breach,Raze,Brimstone,Sage,Chamber",1588
59328,26668,"VCT Brazil 2022 - Stage 1 Challengers 1 - Playoffs","Bind",6344,"LOUD",5750,"Ninjas in Pyjamas",1,13,4,10,2,1,1,0,10,2,3,2,1,1,0,2,3,2,10,"standard","2022-03-27T00:00:00.000Z","[4748,2294,6037,4746,2895]","[3203,3408,762,2195,16804]","Raze,Sova,Brimstone,Sage,KAY/O","Raze,Brimstone,Sage,Jett,Skye",1588
59306,26662,"VCT EMEA 2022 - Stage 1 Challengers - Playoffs","Ascent",17,"FunPlus Phoenix",194,"G2 Esports (Inactive)",2,13,7,7,5,2,1,1,6,2,7,5,0,0,0,5,7,2,6,"standard","2022-03-27T00:00:00.000Z","[2225,2335,1256,7705,2359]","[1826,2377,2769,2940,2594]","Cypher,Sova,Sage,Omen,Jett","Sova,Killjoy,Omen,Jett,KAY/O",1588
59305,26662,"VCT EMEA 2022 - Stage 1 Challengers - Playoffs","Breeze",17,"FunPlus Phoenix",194,"G2 Esports (Inactive)",1,8,13,5,7,1,1,0,5,7,3,6,1,1,0,6,3,7,5,"standard","2022-03-27T00:00:00.000Z","[2225,2359,7705,2335,1256]","[2594,2377,1826,2769,2940]","Cypher,Sova,Viper,Jett,KAY/O","Sova,Viper,Jett,KAY/O,Chamber",1588
59304,26662,"VCT EMEA 2022 - Stage 1 Challengers - Playoffs","Icebox",17,"FunPlus Phoenix",194,"G2 Esports (Inactive)",2,13,6,8,4,1,1,0,5,2,8,4,1,1,0,4,8,2,5,"standard","2022-03-27T00:00:00.000Z","[2335,2225,7705,2359,1256]","[1826,2377,2769,2594,2940]","Sova,Viper,Sage,Jett,KAY/O","Sova,Killjoy,Viper,Sage,Chamber",1588
59382,26681,"VCT Japan 2022 - Stage 1 Challengers 1 - Playoffs","Icebox",611,"ZETA DIVISION",444,"Crazy Raccoon",1,13,10,5,7,0,0,0,5,7,8,3,2,1,1,3,8,7,5,"standard","2022-03-27T00:00:00.000Z","[2699,2232,519,1593,2212]","[1231,2388,8025,1886,876]","Sova,Viper,Sage,Jett,Chamber","Sova,Killjoy,Viper,Reyna,Jett",1588
59393,26683,"VCT 2022: APAC Stage 1 Challengers - Playoffs","Haven",5903,"XERXIA Esports",184,"Paper Rex",1,8,13,6,6,0,0,0,6,6,2,7,2,1,1,7,2,6,6,"standard","2022-03-27T00:00:00.000Z","[3642,671,766,21245,6890]","[432,8387,8385,8386,8388]","Breach,Killjoy,Omen,Jett,Skye","Raze,Cypher,Omen,Jett,Skye",1588
59381,26681,"VCT Japan 2022 - Stage 1 Challengers 1 - Playoffs","Haven",611,"ZETA DIVISION",444,"Crazy Raccoon",2,10,13,2,10,1,1,0,8,3,2,10,1,1,0,10,2,3,8,"standard","2022-03-27T00:00:00.000Z","[2699,2212,1593,519,2232]","[1231,8025,2388,876,1886]","Breach,Killjoy,Jett,Skye,Astra","Sova,Killjoy,Omen,Jett,Skye",1588
59392,26683,"VCT 2022: APAC Stage 1 Challengers - Playoffs","Breeze",5903,"XERXIA Esports",184,"Paper Rex",2,13,11,7,5,0,0,0,6,6,7,5,2,1,1,5,7,6,6,"standard","2022-03-27T00:00:00.000Z","[766,21245,6890,3642,671]","[8387,8385,432,8386,8388]","Viper,Jett,Skye,KAY/O,Chamber","Sova,Viper,Reyna,Jett,Chamber",1588
59386,26682,"VCT Korea 2022 - Stage 1 Challengers - Playoffs","Ascent",5373,"On Sla2ers",286,"DRX",1,2,13,2,10,0,0,0,2,10,0,3,2,1,1,3,0,10,2,"standard","2022-03-27T00:00:00.000Z","[1199,2151,1075,2009,2904]","[814,1251,452,1550,582]","Sova,Killjoy,Jett,Astra,KAY/O","Sova,Killjoy,Omen,Jett,KAY/O",1588
59380,26681,"VCT Japan 2022 - Stage 1 Challengers 1 - Playoffs","Split",611,"ZETA DIVISION",444,"Crazy Raccoon",1,13,6,9,3,1,1,0,9,3,4,3,1,1,0,3,4,3,9,"standard","2022-03-27T00:00:00.000Z","[519,2212,1593,2699,2232]","[8025,1231,2388,876,1886]","Raze,Viper,Sage,Skye,Astra","Killjoy,Sage,Omen,Jett,Skye",1588
59391,26683,"VCT 2022: APAC Stage 1 Challengers - Playoffs","Icebox",5903,"XERXIA Esports",184,"Paper Rex",2,6,13,2,10,0,0,0,4,3,2,10,2,1,1,10,2,3,4,"standard","2022-03-27T00:00:00.000Z","[6890,766,3642,21245,671]","[8387,8385,8388,432,8386]","Sova,Viper,Omen,Jett,Chamber","Sova,Viper,Sage,Reyna,Jett",1588
59385,26682,"VCT Korea 2022 - Stage 1 Challengers - Playoffs","Fracture",5373,"On Sla2ers",286,"DRX",2,4,13,4,8,0,0,0,0,5,4,8,2,1,1,8,4,5,0,"standard","2022-03-27T00:00:00.000Z","[2904,1075,2151,2009,1199]","[582,1550,452,814,1251]","Breach,Raze,Viper,Astra,Chamber","Breach,Raze,Viper,Brimstone,Chamber",1588
59379,26681,"VCT Japan 2022 - Stage 1 Challengers 1 - Playoffs","Bind",611,"ZETA DIVISION",444,"Crazy Raccoon",2,14,12,3,9,1,1,0,10,3,4,9,1,1,0,9,4,3,10,"standard","2022-03-27T00:00:00.000Z","[519,2212,1593,2699,2232]","[1231,8025,2388,876,1886]","Raze,Viper,Sage,Skye,Astra","Sova,Killjoy,Brimstone,Jett,Skye",1588
59390,26683,"VCT 2022: APAC Stage 1 Challengers - Playoffs","Split",5903,"XERXIA Esports",184,"Paper Rex",2,13,8,7,5,2,1,1,6,3,7,5,0,0,0,5,7,3,6,"standard","2022-03-27T00:00:00.000Z","[3642,21245,671,766,6890]","[432,8387,8388,8385,8386]","Breach,Raze,Killjoy,Omen,KAY/O","Raze,Cypher,Sage,Omen,Jett",1588
59389,26683,"VCT 2022: APAC Stage 1 Challengers - Playoffs","Fracture",5903,"XERXIA Esports",184,"Paper Rex",1,4,13,3,9,1,0,1,3,9,1,4,1,0,1,4,1,9,3,"standard","2022-03-27T00:00:00.000Z","[3642,21245,766,6890,671]","[8387,8385,432,8388,8386]","Breach,Raze,Brimstone,Jett,Chamber","Breach,Viper,Sage,Chamber,Neon",1588
59384,26682,"VCT Korea 2022 - Stage 1 Challengers - Playoffs","Haven",5373,"On Sla2ers",286,"DRX",2,12,14,3,9,2,1,1,9,4,3,10,0,0,0,10,3,4,9,"standard","2022-03-27T00:00:00.000Z","[2904,1199,2151,1075,2009]","[582,814,1251,452,1550]","Breach,Sova,Killjoy,Jett,Astra","Breach,Sova,Killjoy,Omen,Jett",1588
59377,26680,"VCT Japan 2022 - Stage 1 Challengers 1 - Playoffs","Ascent",5294,"IGZIST",444,"Crazy Raccoon",1,1,13,1,11,0,0,0,1,11,0,2,2,1,1,2,0,11,1,"standard","2022-03-27T00:00:00.000Z","[3521,2015,1401,1603,2049]","[1231,8025,2388,876,1886]","Sova,Killjoy,Omen,Jett,KAY/O","Sova,Killjoy,Omen,Jett,Skye",1588
59376,26680,"VCT Japan 2022 - Stage 1 Challengers 1 - Playoffs","Haven",5294,"IGZIST",444,"Crazy Raccoon",2,2,13,2,10,0,0,0,0,3,2,10,2,1,1,10,2,3,0,"standard","2022-03-27T00:00:00.000Z","[2049,3521,1401,1603,2015]","[1231,8025,2388,876,1886]","Breach,Sova,Omen,Jett,Chamber","Sova,Killjoy,Omen,Jett,Skye",1588
59373,26679,"VCT 2022: APAC Stage 1 Challengers - Playoffs","Haven",4838,"Bleed Esports",5903,"XERXIA Esports",1,12,14,7,5,0,0,0,7,6,5,8,2,1,1,8,5,6,7,"standard","2022-03-27T00:00:00.000Z","[2639,6625,645,7877,6639]","[3642,671,21245,6890,766]","Breach,Sova,Killjoy,Omen,Jett","Breach,Killjoy,Jett,Skye,Astra",1588
59372,26679,"VCT 2022: APAC Stage 1 Challengers - Playoffs","Bind",4838,"Bleed Esports",5903,"XERXIA Esports",2,4,13,2,10,0,0,0,2,3,2,10,2,1,1,10,2,3,2,"standard","2022-03-27T00:00:00.000Z","[2639,6625,7877,645,6639]","[6890,21245,3642,766,671]","Breach,Sova,Viper,Brimstone,Jett","Sova,Jett,Skye,Astra,Chamber",1588
59371,26679,"VCT 2022: APAC Stage 1 Challengers - Playoffs","Ascent",4838,"Bleed Esports",5903,"XERXIA Esports",2,13,10,7,5,1,1,0,6,5,7,5,1,1,0,5,7,5,6,"standard","2022-03-27T00:00:00.000Z","[2639,6625,645,7877,6639]","[671,6890,21245,766,3642]","Breach,Sova,Killjoy,Omen,Jett","Cypher,Sova,Jett,Astra,KAY/O",1588
59321,26665,"VCT Latin America Stage 1 Stage 1: Playoffs","Split",553,"E-Xolos LAZER",738,"Leviatán",1,8,13,4,8,2,1,1,4,8,4,5,0,0,0,5,4,8,4,"standard","2022-03-27T00:00:00.000Z","[2773,3274,3252,1500,1141]","[6414,3555,3531,3421,3532]","Raze,Viper,Omen,Jett,Skye","Raze,Cypher,Sage,Omen,Jett",1588
59320,26665,"VCT Latin America Stage 1 Stage 1: Playoffs","Haven",553,"E-Xolos LAZER",738,"Leviatán",1,8,13,6,6,2,1,1,6,6,2,7,0,0,0,7,2,6,6,"standard","2022-03-26T00:00:00.000Z","[1500,1141,3252,3274,2773]","[6414,3531,3555,3421,3532]","Raze,Sova,Omen,KAY/O,Chamber","Breach,Sova,Killjoy,Omen,Jett",1588
59335,26669,"VCT North America 2022 - Stage 1 Challengers - Main Event","Split",5201,"The Guard",141,"Cloud9",1,13,10,4,8,2,1,1,4,8,9,2,0,0,0,2,9,8,4,"standard","2022-03-26T00:00:00.000Z","[11412,1804,2551,1091,4141]","[1961,3599,4639,13591,2213]","Breach,Omen,Jett,Skye,Chamber","Breach,Raze,Omen,KAY/O,Chamber",1588
59319,26665,"VCT Latin America Stage 1 Stage 1: Playoffs","Bind",553,"E-Xolos LAZER",738,"Leviatán",2,13,9,6,6,0,0,0,7,3,6,6,2,1,1,6,6,3,7,"standard","2022-03-26T00:00:00.000Z","[1500,3274,3252,1141,2773]","[6414,3555,3421,3531,3532]","Raze,Sova,Brimstone,Skye,Chamber","Raze,Viper,Brimstone,Sage,Skye",1588
59334,26669,"VCT North America 2022 - Stage 1 Challengers - Main Event","Haven",5201,"The Guard",141,"Cloud9",2,13,5,8,4,1,1,0,5,1,8,4,1,1,0,4,8,1,5,"standard","2022-03-26T00:00:00.000Z","[1091,1804,2551,11412,4141]","[1961,3599,4639,13591,2213]","Breach,Omen,Jett,Skye,Chamber","Breach,Raze,Omen,Skye,Chamber",1588
59323,26666,"VCT Latin America Stage 1 Stage 1: Playoffs","Bind",976,"KRÜ Esports",6025,"FUSION",2,13,1,11,1,2,1,1,2,0,11,1,0,0,0,1,11,0,2,"standard","2022-03-26T00:00:00.000Z","[1725,4712,3535,2532,4710]","[23698,2609,3269,1428,5350]","Raze,Viper,Brimstone,Sage,Skye","Raze,Viper,Brimstone,Skye,Chamber",1588
59348,26667,"VCT Brazil 2022 - Stage 1 Challengers 1 - Playoffs","Split",5750,"Ninjas in Pyjamas",600,"Keyd Stars",1,13,3,9,3,1,0,1,9,3,4,0,1,0,1,0,4,3,9,"standard","2022-03-26T00:00:00.000Z","[3203,762,16804,3408,2195]","[81,1661,2901,5288,277]","Raze,Cypher,Sage,Omen,Jett","Raze,Sage,Omen,Jett,Chamber",1588
59333,26669,"VCT North America 2022 - Stage 1 Challengers - Main Event","Icebox",5201,"The Guard",141,"Cloud9",2,17,15,7,5,1,0,1,7,9,10,6,1,0,1,6,10,9,7,"standard","2022-03-26T00:00:00.000Z","[11412,1804,1091,2551,4141]","[1961,4639,13591,3599,2213]","Sova,Viper,Omen,Jett,Chamber","Sova,Viper,Sage,Jett,Chamber",1588
59322,26666,"VCT Latin America Stage 1 Stage 1: Playoffs","Haven",976,"KRÜ Esports",6025,"FUSION",2,13,4,9,3,1,1,0,4,1,9,3,1,1,0,3,9,1,4,"standard","2022-03-26T00:00:00.000Z","[4712,4710,1725,3535,2532]","[1428,3269,5350,23698,2609]","Cypher,Sova,Phoenix,Omen,Jett","Breach,Brimstone,Jett,KAY/O,Chamber",1588
59347,26667,"VCT Brazil 2022 - Stage 1 Challengers 1 - Playoffs","Haven",5750,"Ninjas in Pyjamas",600,"Keyd Stars",1,9,13,7,5,2,1,1,7,5,2,8,0,0,0,8,2,5,7,"standard","2022-03-26T00:00:00.000Z","[762,16804,3408,3203,2195]","[81,2901,1661,5288,277]","Cypher,Sova,Omen,Jett,KAY/O","Sova,Brimstone,Sage,Jett,Chamber",1588
59327,26667,"VCT Brazil 2022 - Stage 1 Challengers 1 - Playoffs","Icebox",5750,"Ninjas in Pyjamas",600,"Keyd Stars",1,15,17,6,6,2,1,1,8,8,7,9,0,0,0,9,7,8,8,"standard","2022-03-26T00:00:00.000Z","[16804,3408,762,2195,3203]","[81,277,2901,1661,5288]","Sova,Viper,Sage,Reyna,Jett","Sova,Killjoy,Viper,Sage,Jett",1588
59326,26667,"VCT Brazil 2022 - Stage 1 Challengers 1 - Playoffs","Ascent",5750,"Ninjas in Pyjamas",600,"Keyd Stars",1,13,11,5,7,0,0,0,5,7,8,4,2,1,1,4,8,7,5,"standard","2022-03-26T00:00:00.000Z","[16804,762,2195,3408,3203]","[81,1661,277,2901,5288]","Sova,Killjoy,Reyna,Omen,Jett","Sova,Killjoy,Sage,Omen,Jett",1588
59311,26663,"VCT EMEA 2022 - Stage 1 Challengers - Playoffs","Ascent",1625,"FNATIC",194,"G2 Esports (Inactive)",2,10,13,4,8,2,1,1,6,5,4,8,0,0,0,8,4,5,6,"standard","2022-03-26T00:00:00.000Z","[2290,154,2937,76,2011]","[1826,2377,2769,2940,2594]","Sova,Killjoy,Jett,Astra,KAY/O","Sova,Killjoy,Omen,Jett,KAY/O",1588
59325,26667,"VCT Brazil 2022 - Stage 1 Challengers 1 - Playoffs","Breeze",5750,"Ninjas in Pyjamas",600,"Keyd Stars",2,13,8,6,6,1,1,0,7,2,6,6,1,1,0,6,6,2,7,"standard","2022-03-26T00:00:00.000Z","[762,16804,3408,2195,3203]","[1661,81,2901,5288,277]","Cypher,Sova,Viper,Reyna,Jett","Cypher,Sova,Viper,Jett,KAY/O",1588
59310,26663,"VCT EMEA 2022 - Stage 1 Challengers - Playoffs","Icebox",1625,"FNATIC",194,"G2 Esports (Inactive)",1,2,13,2,10,0,0,0,2,10,0,3,2,1,1,3,0,10,2,"standard","2022-03-26T00:00:00.000Z","[2290,154,76,2011,2937]","[1826,2377,2769,2594,2940]","Sova,Killjoy,Viper,Sage,Jett","Sova,Killjoy,Viper,Sage,Chamber",1588
59309,26663,"VCT EMEA 2022 - Stage 1 Challengers - Playoffs","Breeze",1625,"FNATIC",194,"G2 Esports (Inactive)",2,9,13,6,6,2,1,1,3,7,6,6,0,0,0,6,6,7,3,"standard","2022-03-26T00:00:00.000Z","[2290,76,2937,2011,154]","[2594,2377,1826,2769,2940]","Sova,Viper,Jett,Skye,Chamber","Sova,Viper,Jett,KAY/O,Chamber",1588
59345,26672,"VCT Japan 2022 - Stage 1 Challengers 1 - Playoffs","Icebox",488,"FAV gaming",444,"Crazy Raccoon",1,6,13,4,8,0,0,0,4,8,2,5,2,1,1,5,2,8,4,"standard","2022-03-26T00:00:00.000Z","[9576,3035,8883,1824,314]","[1231,2388,8025,1886,876]","Sova,Viper,Sage,Reyna,Jett","Sova,Killjoy,Viper,Reyna,Jett",1588
59343,26671,"VCT 2022: APAC Stage 1 Challengers - Playoffs","Ascent",5903,"XERXIA Esports",15,"BOOM Esports",1,13,7,6,6,2,1,1,6,6,7,1,0,0,0,1,7,6,6,"standard","2022-03-26T00:00:00.000Z","[671,6890,21245,766,3642]","[1919,3361,3363,3365,217]","Cypher,Sova,Jett,Astra,KAY/O","Sova,Killjoy,Jett,Astra,KAY/O",1588
59344,26672,"VCT Japan 2022 - Stage 1 Challengers 1 - Playoffs","Haven",488,"FAV gaming",444,"Crazy Raccoon",1,6,13,3,9,1,0,1,3,9,3,4,1,0,1,4,3,9,3,"standard","2022-03-26T00:00:00.000Z","[8883,3035,1824,9576,314]","[1231,8025,2388,876,1886]","Breach,Omen,Jett,KAY/O,Chamber","Sova,Killjoy,Omen,Jett,Skye",1588
59342,26671,"VCT 2022: APAC Stage 1 Challengers - Playoffs","Haven",5903,"XERXIA Esports",15,"BOOM Esports",1,13,6,9,3,1,1,0,9,3,4,3,1,1,0,3,4,3,9,"standard","2022-03-26T00:00:00.000Z","[3642,671,21245,6890,766]","[217,3361,1919,3363,3365]","Breach,Killjoy,Jett,Skye,Astra","Breach,Cypher,Sova,Jett,Astra",1588
59341,26671,"VCT 2022: APAC Stage 1 Challengers - Playoffs","Split",5903,"XERXIA Esports",15,"BOOM Esports",2,8,13,5,7,1,1,0,3,6,5,7,1,1,0,7,5,6,3,"standard","2022-03-26T00:00:00.000Z","[3642,671,21245,6890,766]","[3363,3361,1919,217,3365]","Breach,Killjoy,Jett,Skye,Astra","Raze,Killjoy,Sage,Skye,Astra",1588
59296,26659,"VCT Japan 2022 - Stage 1 Challengers 1 - Playoffs","Fracture",611,"ZETA DIVISION",5294,"IGZIST",1,13,2,10,2,1,0,1,10,2,3,0,1,0,1,0,3,2,10,"standard","2022-03-26T00:00:00.000Z","[2699,519,1593,2232,2212]","[2049,3521,2015,1401,1603]","Breach,Raze,Viper,Astra,Chamber","Breach,Raze,Viper,Astra,Chamber",1588
59287,26656,"VCT 2022: APAC Stage 1 Challengers - Playoffs","Split",4838,"Bleed Esports",184,"Paper Rex",2,4,13,2,10,1,0,1,2,3,2,10,1,0,1,10,2,3,2,"standard","2022-03-26T00:00:00.000Z","[6625,645,7877,2639,6639]","[432,8387,8388,8385,8386]","Breach,Cypher,Brimstone,Sage,Jett","Raze,Cypher,Sage,Omen,Jett",1588
59295,26659,"VCT Japan 2022 - Stage 1 Challengers 1 - Playoffs","Bind",611,"ZETA DIVISION",5294,"IGZIST",2,13,4,8,4,1,1,0,5,0,8,4,1,1,0,4,8,0,5,"standard","2022-03-26T00:00:00.000Z","[519,2212,1593,2699,2232]","[2049,1603,3521,1401,2015]","Raze,Viper,Sage,Skye,Astra","Breach,Raze,Sova,Brimstone,Chamber",1588
58862,26480,"VCT Korea 2022 - Stage 1 Challengers - Playoffs","Bind",5373,"On Sla2ers",6510,"HolyMolly",1,13,2,10,2,1,0,1,10,2,3,0,1,0,1,0,3,2,10,"standard","2022-03-26T00:00:00.000Z","[1075,2151,2009,2904,1199]","[1810,3186,15725,2508,2908]","Raze,Viper,Brimstone,Sage,Skye","Viper,Brimstone,Sage,Skye,Chamber",1588
58861,26480,"VCT Korea 2022 - Stage 1 Challengers - Playoffs","Ascent",5373,"On Sla2ers",6510,"HolyMolly",2,13,1,11,1,2,1,1,2,0,11,1,0,0,0,1,11,0,2,"standard","2022-03-26T00:00:00.000Z","[1199,2151,1075,2009,2904]","[2908,1810,15725,3186,2508]","Sova,Killjoy,Jett,Astra,KAY/O","Sova,Killjoy,Viper,Brimstone,KAY/O",1588
59286,26656,"VCT 2022: APAC Stage 1 Challengers - Playoffs","Icebox",4838,"Bleed Esports",184,"Paper Rex",1,13,15,10,2,1,1,0,11,3,2,12,1,1,0,12,2,3,11,"standard","2022-03-26T00:00:00.000Z","[6625,7877,2639,6639,645]","[8387,8385,432,8386,8388]","Sova,Viper,Sage,Jett,Chamber","Sova,Viper,Sage,Jett,Chamber",1588
59303,26661,"VCT Japan 2022 - Stage 1 Challengers 1 - Playoffs","Haven",444,"Crazy Raccoon",334,"REJECT",1,13,7,7,5,1,1,0,7,5,6,2,1,1,0,2,6,5,7,"standard","2022-03-26T00:00:00.000Z","[1231,8025,2388,876,1886]","[3011,2791,2584,852,705]","Sova,Killjoy,Omen,Jett,Skye","Cypher,Brimstone,Reyna,Jett,Skye",1588
58860,26480,"VCT Korea 2022 - Stage 1 Challengers - Playoffs","Haven",5373,"On Sla2ers",6510,"HolyMolly",1,13,9,5,7,1,0,1,5,7,8,2,1,0,1,2,8,7,5,"standard","2022-03-26T00:00:00.000Z","[2904,1199,2151,1075,2009]","[2508,2908,1810,3186,15725]","Breach,Sova,Killjoy,Jett,Astra","Breach,Sova,Killjoy,Omen,Jett",1588
59302,26661,"VCT Japan 2022 - Stage 1 Challengers 1 - Playoffs","Bind",444,"Crazy Raccoon",334,"REJECT",2,13,6,9,3,2,1,1,4,3,9,3,0,0,0,3,9,3,4,"standard","2022-03-26T00:00:00.000Z","[1231,8025,2388,876,1886]","[852,2791,3011,705,2584]","Sova,Killjoy,Brimstone,Jett,Skye","Raze,Viper,Brimstone,Sage,Skye",1588
59293,26658,"VCT 2022: APAC Stage 1 Challengers - Playoffs","Breeze",227,"FULL SENSE",15,"BOOM Esports",1,9,13,4,8,2,1,1,4,8,5,5,0,0,0,5,5,8,4,"standard","2022-03-26T00:00:00.000Z","[2122,2667,2018,531,676]","[3361,1919,3365,3363,217]","Sova,Viper,Jett,Skye,Chamber","Cypher,Sova,Viper,Jett,KAY/O",1588
59301,26661,"VCT Japan 2022 - Stage 1 Challengers 1 - Playoffs","Ascent",444,"Crazy Raccoon",334,"REJECT",1,13,15,5,7,1,0,1,5,9,8,6,1,0,1,6,8,9,5,"standard","2022-03-26T00:00:00.000Z","[1231,8025,2388,876,1886]","[2584,3011,2791,852,705]","Sova,Killjoy,Omen,Jett,Skye","Sova,Killjoy,Brimstone,Jett,KAY/O",1588
59292,26658,"VCT 2022: APAC Stage 1 Challengers - Playoffs","Ascent",227,"FULL SENSE",15,"BOOM Esports",2,11,13,7,5,1,0,1,4,8,7,5,1,0,1,5,7,8,4,"standard","2022-03-26T00:00:00.000Z","[2122,2667,2018,676,531]","[1919,3361,3363,3365,217]","Sova,Killjoy,Jett,Astra,KAY/O","Sova,Killjoy,Jett,Astra,KAY/O",1588
59290,26657,"VCT 2022: APAC Stage 1 Challengers - Playoffs","Haven",5903,"XERXIA Esports",6635,"Persija Esports",1,13,3,9,3,1,0,1,9,3,4,0,1,0,1,0,4,3,9,"standard","2022-03-26T00:00:00.000Z","[3642,671,21245,6890,766]","[386,6834,3495,2421,3373]","Breach,Killjoy,Jett,Skye,Astra","Raze,Sova,Killjoy,Brimstone,Jett",1588
59299,26660,"VCT Japan 2022 - Stage 1 Challengers 1 - Playoffs","Haven",488,"FAV gaming",1840,"NORTHEPTION",1,13,8,5,7,1,0,1,5,7,8,1,1,0,1,1,8,7,5,"standard","2022-03-26T00:00:00.000Z","[8883,3035,1824,9576,314]","[3060,3968,8882,12341,652]","Breach,Omen,Jett,KAY/O,Chamber","Breach,Killjoy,Omen,Jett,Skye",1588
59289,26657,"VCT 2022: APAC Stage 1 Challengers - Playoffs","Ascent",5903,"XERXIA Esports",6635,"Persija Esports",1,13,11,9,3,1,1,0,9,3,4,8,1,1,0,8,4,3,9,"standard","2022-03-26T00:00:00.000Z","[671,6890,21245,766,3642]","[6834,3495,3373,2421,386]","Cypher,Sova,Jett,Astra,KAY/O","Sova,Killjoy,Jett,Astra,KAY/O",1588
59298,26660,"VCT Japan 2022 - Stage 1 Challengers 1 - Playoffs","Ascent",488,"FAV gaming",1840,"NORTHEPTION",2,13,6,10,2,0,0,0,3,4,10,2,2,1,1,2,10,4,3,"standard","2022-03-26T00:00:00.000Z","[8883,9576,3035,314,1824]","[652,3968,8882,12341,3060]","Sova,Killjoy,Omen,Jett,KAY/O","Sova,Killjoy,Omen,Jett,KAY/O",1588
59280,26654,"VCT North America 2022 - Stage 1 Challengers - Main Event","Ascent",603,"XSET",141,"Cloud9",1,2,13,2,10,0,0,0,2,10,0,3,2,1,1,3,0,10,2,"standard","2022-03-26T00:00:00.000Z","[3346,494,3062,1802,3582]","[1961,2213,4639,3599,13591]","Sova,Killjoy,Brimstone,Jett,KAY/O","Sova,Killjoy,Omen,Jett,KAY/O",1588
59279,26654,"VCT North America 2022 - Stage 1 Challengers - Main Event","Split",603,"XSET",141,"Cloud9",1,13,11,5,7,1,1,0,5,7,8,4,1,1,0,4,8,7,5,"standard","2022-03-25T00:00:00.000Z","[3582,3062,3346,494,1802]","[1961,13591,2213,4639,3599]","Raze,Viper,Skye,Astra,Chamber","Breach,Raze,Killjoy,Omen,Chamber",1588
59317,26664,"VCT Latin America Stage 1 Stage 1: Playoffs","Breeze",738,"Leviatán",6025,"FUSION",2,13,7,7,5,2,1,1,6,2,7,5,0,0,0,5,7,2,6,"standard","2022-03-25T00:00:00.000Z","[3531,3421,3532,6414,3555]","[23698,3269,5350,1428,2609]","Sova,Viper,Jett,KAY/O,Chamber","Sova,Viper,Jett,Skye,Chamber",1588
59278,26654,"VCT North America 2022 - Stage 1 Challengers - Main Event","Haven",603,"XSET",141,"Cloud9",1,4,13,0,12,1,0,1,0,12,4,1,1,0,1,1,4,12,0,"standard","2022-03-25T00:00:00.000Z","[494,3346,3062,1802,3582]","[1961,3599,4639,13591,2213]","Cypher,Sova,Brimstone,Jett,Skye","Breach,Raze,Omen,Skye,Chamber",1588
59316,26664,"VCT Latin America Stage 1 Stage 1: Playoffs","Fracture",738,"Leviatán",6025,"FUSION",2,13,8,7,5,2,1,1,6,3,7,5,0,0,0,5,7,3,6,"standard","2022-03-25T00:00:00.000Z","[3531,6414,3555,3421,3532]","[1428,2609,3269,5350,23698]","Breach,Raze,Cypher,Brimstone,Jett","Breach,Viper,Brimstone,Jett,Chamber",1588
58828,26469,"VCT North America 2022 - Stage 1 Challengers - Main Event","Bind",6426,"OpTic Gaming",5201,"The Guard",2,13,4,8,4,1,1,0,5,0,8,4,1,1,0,4,8,0,5,"standard","2022-03-25T00:00:00.000Z","[3211,2841,398,2483,2716]","[2551,4141,1804,1091,11412]","Raze,Viper,Brimstone,Skye,Chamber","Raze,Viper,Brimstone,Sage,Skye",1588
58827,26469,"VCT North America 2022 - Stage 1 Challengers - Main Event","Split",6426,"OpTic Gaming",5201,"The Guard",2,13,10,6,6,2,1,1,7,4,6,6,0,0,0,6,6,4,7,"standard","2022-03-25T00:00:00.000Z","[2841,398,2483,2716,3211]","[11412,2551,1804,1091,4141]","Breach,Astra,KAY/O,Chamber,Neon","Breach,Raze,Omen,Skye,Chamber",1588
59241,26641,"VCT Brazil 2022 - Stage 1 Challengers 1 - Playoffs","Ascent",6344,"LOUD",5750,"Ninjas in Pyjamas",1,13,4,8,4,1,0,1,8,4,5,0,1,0,1,0,5,4,8,"standard","2022-03-25T00:00:00.000Z","[2294,4746,6037,4748,2895]","[16804,762,2195,3408,3203]","Sova,Killjoy,Omen,Jett,KAY/O","Sova,Killjoy,Sage,Omen,Jett",1588
59252,26645,"VCT EMEA 2022 - Stage 1 Challengers - Playoffs","Split",224,"Team Liquid",194,"G2 Esports (Inactive)",1,4,13,4,8,1,1,0,4,8,0,5,1,1,0,5,0,8,4,"standard","2022-03-25T00:00:00.000Z","[10211,2056,17788,1690,1403]","[2377,1826,2769,2594,2940]","Breach,Raze,Brimstone,Sage,Omen","Breach,Raze,Brimstone,Sage,Chamber",1588
59240,26641,"VCT Brazil 2022 - Stage 1 Challengers 1 - Playoffs","Breeze",6344,"LOUD",5750,"Ninjas in Pyjamas",2,13,6,8,4,0,0,0,5,2,8,4,2,1,1,4,8,2,5,"standard","2022-03-25T00:00:00.000Z","[4746,2294,6037,4748,2895]","[762,16804,3408,2195,3203]","Cypher,Sova,Viper,Jett,Skye","Cypher,Sova,Viper,Reyna,Jett",1588
59251,26645,"VCT EMEA 2022 - Stage 1 Challengers - Playoffs","Icebox",224,"Team Liquid",194,"G2 Esports (Inactive)",2,4,13,3,9,0,0,0,1,4,3,9,2,1,1,9,3,4,1,"standard","2022-03-25T00:00:00.000Z","[2056,1403,10211,1690,17788]","[1826,2377,2769,2594,2940]","Sova,Viper,Omen,Jett,Chamber","Sova,Killjoy,Viper,Sage,Chamber",1588
59239,26641,"VCT Brazil 2022 - Stage 1 Challengers 1 - Playoffs","Haven",6344,"LOUD",5750,"Ninjas in Pyjamas",1,13,11,6,6,1,0,1,6,6,7,5,1,0,1,5,7,6,6,"standard","2022-03-25T00:00:00.000Z","[2895,4746,2294,6037,4748]","[762,16804,3408,3203,2195]","Breach,Cypher,Sova,Omen,Jett","Cypher,Sova,Omen,Jett,KAY/O",1588
59216,26633,"VCT EMEA 2022 - Stage 1 Challengers - Playoffs","Haven",1625,"FNATIC",17,"FunPlus Phoenix",2,10,13,3,9,2,1,1,7,4,3,9,0,0,0,9,3,4,7,"standard","2022-03-25T00:00:00.000Z","[2011,2290,154,76,2937]","[2359,2225,2335,7705,1256]","Breach,Sova,Killjoy,Omen,Jett","Sova,Killjoy,Jett,Astra,KAY/O",1588
59215,26633,"VCT EMEA 2022 - Stage 1 Challengers - Playoffs","Split",1625,"FNATIC",17,"FunPlus Phoenix",1,0,13,0,12,0,0,0,0,12,0,1,2,1,1,1,0,12,0,"standard","2022-03-25T00:00:00.000Z","[2937,154,2290,76,2011]","[1256,2225,2359,7705,2335]","Raze,Viper,Sage,Omen,KAY/O","Raze,Cypher,Sage,Omen,Jett",1588
59268,26650,"VCT 2022: APAC Stage 1 Challengers - Playoffs","Ascent",15,"BOOM Esports",3390,"South Built Esports",2,13,6,9,3,1,0,1,4,3,9,3,1,0,1,3,9,3,4,"standard","2022-03-25T00:00:00.000Z","[1919,3361,3363,3365,217]","[13564,13561,13563,13562,12320]","Sova,Killjoy,Jett,Astra,KAY/O","Sova,Killjoy,Jett,Astra,KAY/O",1588
59271,26651,"VCT Japan 2022 - Stage 1 Challengers 1 - Playoffs","Split",488,"FAV gaming",5294,"IGZIST",2,12,14,7,5,1,0,1,5,8,7,6,1,0,1,6,7,8,5,"standard","2022-03-25T00:00:00.000Z","[1824,9576,8883,3035,314]","[2049,2015,3521,1401,1603]","Raze,Cypher,Sage,Omen,Jett","Breach,Killjoy,Sage,Omen,Jett",1588
59267,26650,"VCT 2022: APAC Stage 1 Challengers - Playoffs","Haven",15,"BOOM Esports",3390,"South Built Esports",2,5,13,2,10,1,1,0,3,3,2,10,1,1,0,10,2,3,3,"standard","2022-03-25T00:00:00.000Z","[1919,3361,3363,217,3365]","[12320,13564,13561,13563,13562]","Sova,Killjoy,Jett,Skye,Astra","Breach,Sova,Killjoy,Jett,Astra",1588
59270,26651,"VCT Japan 2022 - Stage 1 Challengers 1 - Playoffs","Bind",488,"FAV gaming",5294,"IGZIST",2,4,13,2,10,1,0,1,2,3,2,10,1,0,1,10,2,3,2,"standard","2022-03-25T00:00:00.000Z","[1824,9576,3035,8883,314]","[2049,1603,3521,1401,2015]","Raze,Viper,Brimstone,Sage,Skye","Breach,Raze,Sova,Brimstone,Chamber",1588
59269,26651,"VCT Japan 2022 - Stage 1 Challengers 1 - Playoffs","Breeze",488,"FAV gaming",5294,"IGZIST",1,13,11,4,8,1,1,0,4,8,9,3,1,1,0,3,9,8,4,"standard","2022-03-25T00:00:00.000Z","[9576,8883,3035,1824,314]","[3521,1401,1603,2049,2015]","Cypher,Sova,Viper,Jett,Skye","Sova,Viper,Jett,KAY/O,Chamber",1588
59266,26650,"VCT 2022: APAC Stage 1 Challengers - Playoffs","Breeze",15,"BOOM Esports",3390,"South Built Esports",1,13,10,9,3,1,1,0,9,3,4,7,1,1,0,7,4,3,9,"standard","2022-03-25T00:00:00.000Z","[3361,1919,3365,3363,217]","[13561,12320,16892,13562,13563]","Cypher,Sova,Viper,Jett,KAY/O","Cypher,Sova,Viper,Jett,KAY/O",1588
59265,26649,"VCT 2022: APAC Stage 1 Challengers - Playoffs","Bind",6635,"Persija Esports",93,"Made in Thailand",1,13,8,7,5,0,0,0,7,5,6,3,2,1,1,3,6,5,7,"standard","2022-03-25T00:00:00.000Z","[386,6834,2421,3495,3373]","[157,2957,347,609,2071]","Raze,Sova,Brimstone,Chamber,Neon","Raze,Viper,Brimstone,Sage,Skye",1588
59244,26642,"VCT Japan 2022 - Stage 1 Challengers 1 - Playoffs","Icebox",611,"ZETA DIVISION",444,"Crazy Raccoon",2,13,5,9,3,2,1,1,4,2,9,3,0,0,0,3,9,2,4,"standard","2022-03-25T00:00:00.000Z","[2699,2232,519,1593,2212]","[1231,2388,8025,1886,876]","Sova,Viper,Sage,Jett,Chamber","Sova,Killjoy,Viper,Reyna,Jett",1588
59264,26649,"VCT 2022: APAC Stage 1 Challengers - Playoffs","Breeze",6635,"Persija Esports",93,"Made in Thailand",1,7,13,4,8,1,0,1,4,8,3,5,1,0,1,5,3,8,4,"standard","2022-03-25T00:00:00.000Z","[2421,6834,3373,386,3495]","[609,347,157,2071,2957]","Sova,Viper,Jett,Skye,Chamber","Sova,Viper,Jett,KAY/O,Chamber",1588
59243,26642,"VCT Japan 2022 - Stage 1 Challengers 1 - Playoffs","Haven",611,"ZETA DIVISION",444,"Crazy Raccoon",2,13,7,9,3,1,1,0,4,4,9,3,1,1,0,3,9,4,4,"standard","2022-03-25T00:00:00.000Z","[2699,2212,1593,519,2232]","[1231,8025,2388,876,1886]","Breach,Killjoy,Jett,Skye,Astra","Sova,Killjoy,Omen,Jett,Skye",1588
59242,26642,"VCT Japan 2022 - Stage 1 Challengers 1 - Playoffs","Breeze",611,"ZETA DIVISION",444,"Crazy Raccoon",1,8,13,4,8,1,0,1,4,8,4,5,1,0,1,5,4,8,4,"standard","2022-03-25T00:00:00.000Z","[2699,2232,1593,519,2212]","[1231,8025,1886,2388,876]","Sova,Viper,Jett,Skye,Chamber","Sova,Viper,Jett,KAY/O,Chamber",1588
59263,26649,"VCT 2022: APAC Stage 1 Challengers - Playoffs","Haven",6635,"Persija Esports",93,"Made in Thailand",2,15,13,6,6,1,0,1,7,7,8,6,1,0,1,6,8,7,7,"standard","2022-03-25T00:00:00.000Z","[386,6834,3495,2421,3373]","[609,2957,157,2071,347]","Raze,Sova,Killjoy,Brimstone,Jett","Sova,Killjoy,Jett,Skye,Astra",1588
59261,26648,"VCT 2022: APAC Stage 1 Challengers - Playoffs","Haven",5903,"XERXIA Esports",184,"Paper Rex",1,11,13,6,6,2,1,1,6,6,5,7,0,0,0,7,5,6,6,"standard","2022-03-25T00:00:00.000Z","[3642,671,21245,6890,766]","[8387,432,8385,8386,8388]","Breach,Killjoy,Jett,Skye,Astra","Cypher,Sage,Omen,Jett,Skye",1588
59276,26653,"VCT Japan 2022 - Stage 1 Challengers 1 - Playoffs","Haven",334,"REJECT",483,"Crest Gaming ZST",1,13,4,8,4,2,1,1,8,4,5,0,0,0,0,0,5,4,8,"standard","2022-03-25T00:00:00.000Z","[3011,2791,2584,852,705]","[3020,2109,12262,23152,146]","Cypher,Brimstone,Reyna,Jett,Skye","Breach,Killjoy,Brimstone,Jett,Skye",1588
59260,26648,"VCT 2022: APAC Stage 1 Challengers - Playoffs","Bind",5903,"XERXIA Esports",184,"Paper Rex",1,7,13,5,7,0,0,0,5,7,2,6,2,1,1,6,2,7,5,"standard","2022-03-25T00:00:00.000Z","[6890,21245,3642,766,671]","[8387,432,8385,8388,8386]","Sova,Jett,Skye,Astra,Chamber","Breach,Raze,Brimstone,Skye,Yoru",1588
59275,26653,"VCT Japan 2022 - Stage 1 Challengers 1 - Playoffs","Ascent",334,"REJECT",483,"Crest Gaming ZST",2,13,10,5,7,1,1,0,8,3,5,7,1,1,0,7,5,3,8,"standard","2022-03-25T00:00:00.000Z","[2584,3011,2791,852,705]","[2109,3020,23152,146,12262]","Sova,Killjoy,Brimstone,Jett,KAY/O","Cypher,Sova,Jett,Skye,Astra",1588
59259,26647,"VCT 2022: APAC Stage 1 Challengers - Playoffs","Haven",227,"FULL SENSE",4838,"Bleed Esports",2,11,13,7,5,1,1,0,4,8,7,5,1,1,0,5,7,8,4,"standard","2022-03-25T00:00:00.000Z","[531,2122,2018,676,2667]","[2639,6625,645,7877,6639]","Breach,Sova,Jett,Astra,Chamber","Breach,Sova,Killjoy,Omen,Jett",1588
59258,26647,"VCT 2022: APAC Stage 1 Challengers - Playoffs","Bind",227,"FULL SENSE",4838,"Bleed Esports",1,13,6,7,5,2,1,1,7,5,6,1,0,0,0,1,6,5,7,"standard","2022-03-25T00:00:00.000Z","[2122,2018,531,676,2667]","[2639,6625,7877,645,6639]","Sova,Jett,Skye,Astra,Chamber","Breach,Sova,Viper,Brimstone,Jett",1588
59273,26652,"VCT Japan 2022 - Stage 1 Challengers 1 - Playoffs","Fracture",5219,"Reignite",1840,"NORTHEPTION",2,5,13,4,8,2,1,1,1,5,4,8,0,0,0,8,4,5,1,"standard","2022-03-25T00:00:00.000Z","[921,9555,443,2849,10573]","[3060,652,8882,3968,12341]","Breach,Cypher,Sage,Omen,Jett","Breach,Raze,Viper,Astra,Chamber",1588
59257,26647,"VCT 2022: APAC Stage 1 Challengers - Playoffs","Ascent",227,"FULL SENSE",4838,"Bleed Esports",2,4,13,3,9,0,0,0,1,4,3,9,2,1,1,9,3,4,1,"standard","2022-03-25T00:00:00.000Z","[2122,2667,2018,676,531]","[2639,6625,645,7877,6639]","Sova,Killjoy,Jett,Astra,KAY/O","Breach,Sova,Killjoy,Omen,Jett",1588
59272,26652,"VCT Japan 2022 - Stage 1 Challengers 1 - Playoffs","Haven",5219,"Reignite",1840,"NORTHEPTION",1,8,13,5,7,1,0,1,5,7,3,6,1,0,1,6,3,7,5,"standard","2022-03-25T00:00:00.000Z","[443,921,2849,10573,9555]","[3060,3968,8882,12341,652]","Sova,Killjoy,Omen,Jett,KAY/O","Breach,Killjoy,Omen,Jett,Skye",1588
58847,26475,"VCT North America 2022 - Stage 1 Challengers - Main Event","Fracture",141,"Cloud9",1931,"Version1 (Inactive)",1,13,7,7,5,2,1,1,7,5,6,2,0,0,0,2,6,5,7,"standard","2022-03-25T00:00:00.000Z","[1961,13591,4639,2213,3599]","[3056,440,3798,7025,3352]","Breach,Raze,Brimstone,Sage,Chamber","Breach,Raze,Brimstone,Sage,Chamber",1588
58846,26475,"VCT North America 2022 - Stage 1 Challengers - Main Event","Ascent",141,"Cloud9",1931,"Version1 (Inactive)",2,13,10,7,5,2,1,1,6,5,7,5,0,0,0,5,7,5,6,"standard","2022-03-24T00:00:00.000Z","[1961,2213,4639,3599,13591]","[3056,7025,3352,3798,440]","Sova,Killjoy,Omen,Jett,KAY/O","Sova,Killjoy,Jett,Astra,KAY/O",1588
59255,26646,"VCT Brazil 2022 - Stage 1 Challengers 1 - Playoffs","Breeze",1264,"FURIA",600,"Keyd Stars",2,9,13,7,5,1,0,1,2,8,7,5,1,0,1,5,7,8,2,"standard","2022-03-24T00:00:00.000Z","[2752,6039,2423,18192,2749]","[1661,81,2901,5288,277]","Sova,Viper,Jett,KAY/O,Chamber","Cypher,Sova,Viper,Jett,KAY/O",1588
58845,26475,"VCT North America 2022 - Stage 1 Challengers - Main Event","Breeze",141,"Cloud9",1931,"Version1 (Inactive)",2,10,13,6,6,1,1,0,4,7,6,6,1,1,0,6,6,7,4,"standard","2022-03-24T00:00:00.000Z","[2213,1961,4639,3599,13591]","[7025,3056,3798,3352,440]","Cypher,Sova,Viper,Jett,KAY/O","Cypher,Sova,Viper,Jett,KAY/O",1588
59282,26655,"VCT Latin America Stage 1 Stage 1: Playoffs","Ascent",553,"E-Xolos LAZER",976,"KRÜ Esports",2,13,5,9,3,1,0,1,4,2,9,3,1,0,1,3,9,2,4,"standard","2022-03-24T00:00:00.000Z","[1141,3252,1500,3274,2773]","[4710,4712,3535,2532,1725]","Sova,Omen,Jett,KAY/O,Chamber","Sova,Killjoy,Omen,Jett,KAY/O",1588
59254,26646,"VCT Brazil 2022 - Stage 1 Challengers 1 - Playoffs","Icebox",1264,"FURIA",600,"Keyd Stars",1,8,13,5,7,1,1,0,5,7,3,6,1,1,0,6,3,7,5,"standard","2022-03-24T00:00:00.000Z","[2752,6039,18192,2749,2423]","[81,277,2901,1661,5288]","Sova,Viper,Sage,Reyna,Chamber","Sova,Killjoy,Viper,Sage,Jett",1588
59281,26655,"VCT Latin America Stage 1 Stage 1: Playoffs","Fracture",553,"E-Xolos LAZER",976,"KRÜ Esports",1,13,10,6,6,1,0,1,6,6,7,4,1,0,1,4,7,6,6,"standard","2022-03-24T00:00:00.000Z","[1141,2773,3274,3252,1500]","[4710,1725,4712,3535,2532]","Breach,Raze,Cypher,Brimstone,Jett","Breach,Raze,Cypher,Brimstone,Jett",1588
58843,26474,"VCT North America 2022 - Stage 1 Challengers - Main Event","Ascent",279,"Luminosity Gaming",603,"XSET",1,5,13,5,7,0,0,0,5,7,0,6,2,1,1,6,0,7,5,"standard","2022-03-24T00:00:00.000Z","[2489,3345,1522,905,1801]","[3346,494,3062,1802,3582]","Sova,Killjoy,Omen,Jett,KAY/O","Sova,Killjoy,Brimstone,Jett,KAY/O",1588
59162,26615,"VCT Brazil 2022 - Stage 1 Challengers 1 - Playoffs","Haven",600,"Keyd Stars",5747,"TBK Esports",2,13,10,4,8,1,1,0,9,2,4,8,1,1,0,8,4,2,9,"standard","2022-03-24T00:00:00.000Z","[81,2901,1661,5288,277]","[2366,5580,9831,1506,2457]","Sova,Brimstone,Sage,Jett,Chamber","Breach,Sova,Brimstone,Jett,Chamber",1588
58842,26474,"VCT North America 2022 - Stage 1 Challengers - Main Event","Breeze",279,"Luminosity Gaming",603,"XSET",2,5,13,4,8,1,0,1,1,5,4,8,1,0,1,8,4,5,1,"standard","2022-03-24T00:00:00.000Z","[3345,2489,1522,905,1801]","[494,3346,3062,1802,3582]","Cypher,Sova,Viper,Jett,Skye","Cypher,Sova,Viper,Jett,KAY/O",1588
59161,26615,"VCT Brazil 2022 - Stage 1 Challengers 1 - Playoffs","Breeze",600,"Keyd Stars",5747,"TBK Esports",1,13,11,4,8,0,0,0,4,8,9,3,2,1,1,3,9,8,4,"standard","2022-03-24T00:00:00.000Z","[1661,81,2901,5288,277]","[5580,9831,1506,2366,2457]","Cypher,Sova,Viper,Jett,KAY/O","Sova,Viper,Jett,Skye,Chamber",1588
59153,26612,"VCT EMEA 2022 - Stage 1 Challengers - Playoffs","Ascent",224,"Team Liquid",386,"Guild Esports",1,13,8,8,4,1,1,0,8,4,5,4,1,1,0,4,5,4,8,"standard","2022-03-24T00:00:00.000Z","[2056,17788,1403,10211,1690]","[2318,449,1834,2321,966]","Sova,Killjoy,Omen,Jett,KAY/O","Cypher,Sova,Jett,Astra,KAY/O",1588
59157,26613,"VCT Brazil 2022 - Stage 1 Challengers 1 - Playoffs","Haven",1264,"FURIA",580,"Gamelanders Blue",1,14,12,4,8,1,1,0,5,8,9,4,1,1,0,4,9,8,5,"standard","2022-03-24T00:00:00.000Z","[2752,6039,2749,2423,18192]","[622,6038,1427,4747,739]","Killjoy,Sage,Omen,Jett,Skye","Sova,Jett,Astra,KAY/O,Chamber",1588
59152,26612,"VCT EMEA 2022 - Stage 1 Challengers - Playoffs","Breeze",224,"Team Liquid",386,"Guild Esports",2,13,11,8,4,0,0,0,5,7,8,4,2,1,1,4,8,7,5,"standard","2022-03-24T00:00:00.000Z","[10211,1403,1690,2056,17788]","[966,449,2321,1834,2318]","Sova,Viper,Jett,KAY/O,Chamber","Cypher,Sova,Viper,Jett,Skye",1588
59156,26613,"VCT Brazil 2022 - Stage 1 Challengers 1 - Playoffs","Split",1264,"FURIA",580,"Gamelanders Blue",2,7,13,5,7,0,0,0,2,6,5,7,2,1,1,7,5,6,2,"standard","2022-03-24T00:00:00.000Z","[2752,18192,6039,2423,2749]","[4747,739,1427,622,6038]","Raze,Sage,Omen,Jett,Chamber","Raze,Viper,Omen,Skye,Chamber",1588
59155,26613,"VCT Brazil 2022 - Stage 1 Challengers 1 - Playoffs","Ascent",1264,"FURIA",580,"Gamelanders Blue",1,13,5,9,3,1,1,0,9,3,4,2,1,1,0,2,4,3,9,"standard","2022-03-24T00:00:00.000Z","[6039,2752,2749,18192,2423]","[622,739,6038,1427,4747]","Raze,Sova,Omen,KAY/O,Chamber","Sova,Killjoy,Jett,Astra,KAY/O",1588
59159,26614,"VCT EMEA 2022 - Stage 1 Challengers - Playoffs","Bind",6656,"M3 Champions",194,"G2 Esports (Inactive)",1,10,13,6,6,1,1,0,6,6,4,7,1,1,0,7,4,6,6,"standard","2022-03-24T00:00:00.000Z","[3135,1081,274,2528,1964]","[1826,2377,2769,2594,2940]","Raze,Viper,Brimstone,Sage,Skye","Raze,Viper,Omen,Skye,Chamber",1588
59158,26614,"VCT EMEA 2022 - Stage 1 Challengers - Playoffs","Icebox",6656,"M3 Champions",194,"G2 Esports (Inactive)",2,8,13,5,7,0,0,0,3,6,5,7,2,1,1,7,5,6,3,"standard","2022-03-24T00:00:00.000Z","[1964,1081,3135,2528,274]","[1826,2377,2769,2594,2940]","Sova,Omen,Jett,KAY/O,Chamber","Sova,Killjoy,Viper,Sage,Chamber",1588
59219,26634,"VCT 2022: APAC Stage 1 Challengers - Playoffs","Split",184,"Paper Rex",3390,"South Built Esports",1,13,7,9,3,1,0,1,9,3,4,4,1,0,1,4,4,3,9,"standard","2022-03-24T00:00:00.000Z","[432,8387,8388,8385,8386]","[13563,13561,13564,16892,13562]","Raze,Cypher,Sage,Omen,Jett","Raze,Cypher,Sage,Omen,Jett",1588
59231,26638,"VCT Japan 2022 - Stage 1 Challengers 1 - Playoffs","Breeze",483,"Crest Gaming ZST",5294,"IGZIST",2,12,14,8,4,1,0,1,4,9,8,5,1,0,1,5,8,9,4,"standard","2022-03-24T00:00:00.000Z","[3020,12262,23152,146,2109]","[3521,1401,1603,2049,2015]","Sova,Viper,Jett,Skye,Chamber","Sova,Viper,Jett,KAY/O,Chamber",1588
59218,26634,"VCT 2022: APAC Stage 1 Challengers - Playoffs","Haven",184,"Paper Rex",3390,"South Built Esports",2,13,9,4,8,1,1,0,9,1,4,8,1,1,0,8,4,1,9,"standard","2022-03-24T00:00:00.000Z","[8387,432,8385,8386,8388]","[12320,13564,13561,13563,13562]","Cypher,Reyna,Omen,Jett,Skye","Breach,Sova,Killjoy,Jett,Astra",1588
59230,26638,"VCT Japan 2022 - Stage 1 Challengers 1 - Playoffs","Ascent",483,"Crest Gaming ZST",5294,"IGZIST",1,7,13,4,8,1,0,1,4,8,3,5,1,0,1,5,3,8,4,"standard","2022-03-24T00:00:00.000Z","[3020,2109,12262,23152,146]","[3521,2015,1401,1603,2049]","Sova,Killjoy,Omen,Jett,Skye","Sova,Killjoy,Omen,Jett,KAY/O",1588
59213,26632,"VCT 2022: APAC Stage 1 Challengers - Playoffs","Fracture",15,"BOOM Esports",5903,"XERXIA Esports",2,12,14,3,9,1,1,0,9,4,3,10,1,1,0,10,3,4,9,"standard","2022-03-24T00:00:00.000Z","[3365,3363,3361,217,1919]","[3642,671,6890,21245,766]","Breach,Raze,Cypher,Viper,Astra","Breach,Cypher,Sage,Jett,Astra",1588
59228,26637,"VCT Japan 2022 - Stage 1 Challengers 1 - Playoffs","Icebox",334,"REJECT",488,"FAV gaming",1,9,13,3,9,1,0,1,3,9,6,4,1,0,1,4,6,9,3,"standard","2022-03-24T00:00:00.000Z","[2584,2791,705,852,3011]","[9576,3035,8883,1824,314]","Sova,Viper,Sage,Jett,Chamber","Sova,Viper,Sage,Reyna,Jett",1588
59212,26632,"VCT 2022: APAC Stage 1 Challengers - Playoffs","Bind",15,"BOOM Esports",5903,"XERXIA Esports",2,5,13,4,8,1,0,1,1,5,4,8,1,0,1,8,4,5,1,"standard","2022-03-24T00:00:00.000Z","[3361,217,3365,3363,1919]","[6890,21245,3642,766,671]","Sova,Viper,Brimstone,Jett,Skye","Sova,Jett,Skye,Astra,Chamber",1588
59227,26637,"VCT Japan 2022 - Stage 1 Challengers 1 - Playoffs","Bind",334,"REJECT",488,"FAV gaming",1,7,13,5,7,1,0,1,5,7,2,6,1,0,1,6,2,7,5,"standard","2022-03-24T00:00:00.000Z","[852,3011,2791,2584,705]","[1824,9576,3035,8883,314]","Raze,Viper,Brimstone,Sage,Skye","Raze,Viper,Brimstone,Sage,Skye",1588
59211,26631,"VCT 2022: APAC Stage 1 Challengers - Playoffs","Breeze",4838,"Bleed Esports",93,"Made in Thailand",2,13,8,7,5,2,1,1,6,3,7,5,0,0,0,5,7,3,6,"standard","2022-03-24T00:00:00.000Z","[6625,7877,6639,2639,645]","[2957,609,347,157,2071]","Sova,Viper,Jett,Skye,Chamber","Cypher,Sova,Viper,Jett,KAY/O",1588
59226,26636,"VCT Japan 2022 - Stage 1 Challengers 1 - Playoffs","Haven",444,"Crazy Raccoon",1840,"NORTHEPTION",2,13,3,10,2,2,1,1,3,1,10,2,0,0,0,2,10,1,3,"standard","2022-03-24T00:00:00.000Z","[1231,8025,2388,876,1886]","[3060,3968,8882,12341,652]","Sova,Killjoy,Omen,Jett,Skye","Breach,Killjoy,Omen,Jett,Skye",1588
59210,26631,"VCT 2022: APAC Stage 1 Challengers - Playoffs","Haven",4838,"Bleed Esports",93,"Made in Thailand",2,10,13,5,7,1,1,0,5,6,5,7,1,1,0,7,5,6,5,"standard","2022-03-24T00:00:00.000Z","[2639,6625,645,7877,6639]","[609,2957,157,2071,347]","Breach,Sova,Killjoy,Omen,Jett","Sova,Killjoy,Jett,Skye,Astra",1588
59225,26636,"VCT Japan 2022 - Stage 1 Challengers 1 - Playoffs","Ascent",444,"Crazy Raccoon",1840,"NORTHEPTION",1,12,14,7,5,1,1,0,7,6,5,8,1,1,0,8,5,6,7,"standard","2022-03-24T00:00:00.000Z","[1231,8025,2388,876,1886]","[652,3968,8882,12341,3060]","Sova,Killjoy,Omen,Jett,Skye","Sova,Killjoy,Omen,Jett,KAY/O",1588
59224,26636,"VCT Japan 2022 - Stage 1 Challengers 1 - Playoffs","Bind",444,"Crazy Raccoon",1840,"NORTHEPTION",2,13,7,7,5,1,1,0,6,2,7,5,1,1,0,5,7,2,6,"standard","2022-03-24T00:00:00.000Z","[1231,8025,2388,876,1886]","[3060,8882,12341,652,3968]","Sova,Killjoy,Brimstone,Jett,Skye","Breach,Viper,Jett,Skye,Astra",1588
59209,26631,"VCT 2022: APAC Stage 1 Challengers - Playoffs","Ascent",4838,"Bleed Esports",93,"Made in Thailand",1,15,13,5,7,0,0,0,7,7,8,6,2,1,1,6,8,7,7,"standard","2022-03-24T00:00:00.000Z","[2639,6625,645,7877,6639]","[609,2957,157,347,2071]","Breach,Sova,Killjoy,Omen,Jett","Sova,Killjoy,Jett,Astra,KAY/O",1588
59222,26635,"VCT Japan 2022 - Stage 1 Challengers 1 - Playoffs","Haven",611,"ZETA DIVISION",5219,"Reignite",2,13,10,6,6,1,0,1,7,4,6,6,1,0,1,6,6,4,7,"standard","2022-03-24T00:00:00.000Z","[2699,2212,1593,519,2232]","[443,921,2849,10573,9555]","Breach,Killjoy,Jett,Skye,Astra","Sova,Killjoy,Omen,Jett,KAY/O",1588
59207,26630,"VCT 2022: APAC Stage 1 Challengers - Playoffs","Bind",227,"FULL SENSE",6635,"Persija Esports",1,13,11,6,6,1,1,0,6,6,7,5,1,1,0,5,7,6,6,"standard","2022-03-24T00:00:00.000Z","[2122,2018,531,676,2667]","[386,6834,2421,3373,3495]","Sova,Jett,Skye,Astra,Chamber","Raze,Sova,Brimstone,Jett,Chamber",1588
59221,26635,"VCT Japan 2022 - Stage 1 Challengers 1 - Playoffs","Bind",611,"ZETA DIVISION",5219,"Reignite",1,13,11,7,5,1,1,0,7,5,6,6,1,1,0,6,6,5,7,"standard","2022-03-24T00:00:00.000Z","[519,2212,1593,2699,2232]","[921,9555,443,2849,10573]","Raze,Viper,Sage,Skye,Astra","Breach,Raze,Sova,Brimstone,Jett",1588
59206,26630,"VCT 2022: APAC Stage 1 Challengers - Playoffs","Haven",227,"FULL SENSE",6635,"Persija Esports",2,13,10,6,6,1,1,0,7,4,6,6,1,1,0,6,6,4,7,"standard","2022-03-24T00:00:00.000Z","[2122,2018,531,676,2667]","[386,6834,3495,3373,2421]","Sova,Jett,Skye,Astra,Chamber","Raze,Sova,Killjoy,Jett,Astra",1588
58928,26507,"VCT EMEA 2022 - Stage 1 Challengers - Playoffs","Haven",17,"FunPlus Phoenix",224,"Team Liquid",2,13,9,7,5,0,0,0,6,4,7,5,2,1,1,5,7,4,6,"standard","2022-03-23T00:00:00.000Z","[2359,2225,3043,7705,1256]","[1403,2056,10211,1690,17788]","Sova,Killjoy,Jett,Astra,KAY/O","Brimstone,Omen,Jett,Skye,Chamber",1588
58181,26252,"VCT Brazil 2022 - Stage 1 Challengers 1 - Playoffs","Fracture",5750,"Ninjas in Pyjamas",1264,"FURIA",2,13,1,11,1,2,1,1,2,0,11,1,0,0,0,1,11,0,2,"standard","2022-03-23T00:00:00.000Z","[762,3408,2195,3203,16804]","[18192,6039,2752,2749,2423]","Cypher,Brimstone,Sage,Jett,KAY/O","Breach,Raze,Viper,Brimstone,Chamber",1588
58927,26507,"VCT EMEA 2022 - Stage 1 Challengers - Playoffs","Split",17,"FunPlus Phoenix",224,"Team Liquid",2,13,10,5,7,1,1,0,8,3,5,7,1,1,0,7,5,3,8,"standard","2022-03-23T00:00:00.000Z","[1256,2225,2359,7705,3043]","[10211,2056,17788,1690,1403]","Raze,Cypher,Sage,Omen,Jett","Breach,Raze,Brimstone,Sage,Omen",1588
58180,26252,"VCT Brazil 2022 - Stage 1 Challengers 1 - Playoffs","Haven",5750,"Ninjas in Pyjamas",1264,"FURIA",1,14,12,6,6,2,1,1,7,6,7,6,0,0,0,6,7,6,7,"standard","2022-03-23T00:00:00.000Z","[762,16804,3408,3203,2195]","[2752,6039,2749,2423,18192]","Cypher,Sova,Omen,Jett,KAY/O","Killjoy,Sage,Omen,Jett,Skye",1588
58179,26252,"VCT Brazil 2022 - Stage 1 Challengers 1 - Playoffs","Breeze",5750,"Ninjas in Pyjamas",1264,"FURIA",2,11,13,5,7,0,0,0,6,6,5,7,2,1,1,7,5,6,6,"standard","2022-03-23T00:00:00.000Z","[762,16804,3408,2195,3203]","[2752,6039,2423,18192,2749]","Cypher,Sova,Viper,Reyna,Jett","Sova,Viper,Jett,KAY/O,Chamber",1588
58926,26506,"VCT EMEA 2022 - Stage 1 Challengers - Playoffs","Split",1625,"FNATIC",6656,"M3 Champions",2,23,21,9,3,2,1,1,10,12,13,9,0,0,0,9,13,12,10,"standard","2022-03-23T00:00:00.000Z","[2937,154,2290,76,2011]","[2528,1081,1964,274,3135]","Raze,Viper,Sage,Omen,KAY/O","Breach,Astra,KAY/O,Chamber,Neon",1588
58177,26251,"VCT Brazil 2022 - Stage 1 Challengers 1 - Playoffs","Ascent",6344,"LOUD",600,"Keyd Stars",1,13,8,7,5,2,1,1,7,5,6,3,0,0,0,3,6,5,7,"standard","2022-03-23T00:00:00.000Z","[2294,4746,6037,4748,2895]","[81,1661,277,2901,5288]","Sova,Killjoy,Omen,Jett,KAY/O","Sova,Killjoy,Sage,Omen,Jett",1588
58176,26251,"VCT Brazil 2022 - Stage 1 Challengers 1 - Playoffs","Breeze",6344,"LOUD",600,"Keyd Stars",1,13,1,11,1,2,1,1,11,1,2,0,0,0,0,0,2,1,11,"standard","2022-03-23T00:00:00.000Z","[4746,2294,6037,4748,2895]","[1661,81,2901,5288,277]","Cypher,Sova,Viper,Jett,Skye","Cypher,Sova,Viper,Jett,Neon",1588
58925,26506,"VCT EMEA 2022 - Stage 1 Challengers - Playoffs","Bind",1625,"FNATIC",6656,"M3 Champions",1,8,13,5,7,0,0,0,5,7,3,6,2,1,1,6,3,7,5,"standard","2022-03-23T00:00:00.000Z","[2937,2290,154,76,2011]","[3135,1081,274,2528,1964]","Raze,Sova,Viper,Brimstone,Skye","Raze,Viper,Brimstone,Sage,Skye",1588
58924,26506,"VCT EMEA 2022 - Stage 1 Challengers - Playoffs","Fracture",1625,"FNATIC",6656,"M3 Champions",2,13,11,7,5,1,0,1,6,6,7,5,1,0,1,5,7,6,6,"standard","2022-03-23T00:00:00.000Z","[2290,2937,154,2011,76]","[1964,3135,1081,274,2528]","Breach,Raze,Cypher,Viper,Brimstone","Breach,Raze,Cypher,Brimstone,Sage",1588
58923,26505,"VCT EMEA 2022 - Stage 1 Challengers - Playoffs","Haven",194,"G2 Esports (Inactive)",224,"Team Liquid",2,8,13,6,6,1,0,1,2,7,6,6,1,0,1,6,6,7,2,"standard","2022-03-22T00:00:00.000Z","[2377,1826,2769,2594,2940]","[1403,2056,10211,1690,17788]","Breach,Raze,Omen,Skye,Chamber","Brimstone,Omen,Jett,Skye,Chamber",1588
58174,26250,"VCT Brazil 2022 - Stage 1 Challengers 1 - Playoffs","Fracture",5747,"TBK Esports",1264,"FURIA",1,13,15,5,7,0,0,0,5,9,8,6,2,1,1,6,8,9,5,"standard","2022-03-22T00:00:00.000Z","[5580,2366,9831,2457,1506]","[18192,6039,2752,2749,2423]","Breach,Raze,Brimstone,Sage,Chamber","Breach,Raze,Viper,Brimstone,Chamber",1588
58922,26505,"VCT EMEA 2022 - Stage 1 Challengers - Playoffs","Icebox",194,"G2 Esports (Inactive)",224,"Team Liquid",1,15,13,4,8,1,0,1,6,8,9,5,1,0,1,5,9,8,6,"standard","2022-03-22T00:00:00.000Z","[1826,2377,2769,2594,2940]","[2056,1403,10211,1690,17788]","Sova,Killjoy,Viper,Sage,Chamber","Sova,Viper,Omen,Jett,Chamber",1588
58173,26250,"VCT Brazil 2022 - Stage 1 Challengers 1 - Playoffs","Ascent",5747,"TBK Esports",1264,"FURIA",2,10,13,6,6,1,0,1,4,7,6,6,1,0,1,6,6,7,4,"standard","2022-03-22T00:00:00.000Z","[5580,2457,9831,1506,2366]","[6039,2752,2749,18192,2423]","Sova,Killjoy,Brimstone,Jett,Skye","Raze,Sova,Omen,KAY/O,Chamber",1588
58921,26505,"VCT EMEA 2022 - Stage 1 Challengers - Playoffs","Split",194,"G2 Esports (Inactive)",224,"Team Liquid",2,9,13,7,5,1,0,1,2,8,7,5,1,0,1,5,7,8,2,"standard","2022-03-22T00:00:00.000Z","[2377,1826,2769,2594,2940]","[10211,2056,17788,1690,1403]","Breach,Raze,Brimstone,Sage,Chamber","Breach,Raze,Brimstone,Sage,Omen",1588
58171,26249,"VCT Brazil 2022 - Stage 1 Challengers 1 - Playoffs","Haven",600,"Keyd Stars",580,"Gamelanders Blue",1,13,4,8,4,2,1,1,8,4,5,0,0,0,0,0,5,4,8,"standard","2022-03-22T00:00:00.000Z","[81,2901,1661,5288,277]","[622,1427,6038,4747,739]","Sova,Brimstone,Sage,Jett,Chamber","Sova,Omen,Jett,KAY/O,Chamber",1588
58170,26249,"VCT Brazil 2022 - Stage 1 Challengers 1 - Playoffs","Icebox",600,"Keyd Stars",580,"Gamelanders Blue",2,13,5,8,4,2,1,1,5,1,8,4,0,0,0,4,8,1,5,"standard","2022-03-22T00:00:00.000Z","[81,277,2901,1661,5288]","[622,739,1427,4747,6038]","Sova,Killjoy,Viper,Sage,Jett","Sova,Viper,Sage,KAY/O,Chamber",1588
58919,26504,"VCT EMEA 2022 - Stage 1 Challengers - Playoffs","Bind",6656,"M3 Champions",386,"Guild Esports",1,13,6,8,4,1,1,0,8,4,5,2,1,1,0,2,5,4,8,"standard","2022-03-22T00:00:00.000Z","[3135,1081,274,2528,1964]","[1834,966,2321,449,2318]","Raze,Viper,Brimstone,Sage,Skye","Raze,Sova,Brimstone,Sage,Skye",1588
58918,26504,"VCT EMEA 2022 - Stage 1 Challengers - Playoffs","Fracture",6656,"M3 Champions",386,"Guild Esports",2,13,11,4,8,1,1,0,9,3,4,8,1,1,0,8,4,3,9,"standard","2022-03-22T00:00:00.000Z","[1964,3135,1081,274,2528]","[449,966,2318,2321,1834]","Breach,Raze,Cypher,Brimstone,Sage","Breach,Raze,Cypher,Brimstone,Jett",1588
58858,26479,"VCT 2022: APAC Stage 1 Challengers - Group Stage","Haven",212,"Velocity Gaming",3390,"South Built Esports",1,6,13,4,8,1,0,1,4,8,2,5,1,0,1,5,2,8,4,"standard","2022-03-21T00:00:00.000Z","[1913,2059,226,342,927]","[12320,13564,13561,13563,13562]","Sova,Killjoy,Omen,Jett,KAY/O","Breach,Sova,Killjoy,Jett,Astra",1588
58857,26479,"VCT 2022: APAC Stage 1 Challengers - Group Stage","Ascent",212,"Velocity Gaming",3390,"South Built Esports",2,11,13,8,4,1,0,1,3,9,8,4,1,0,1,4,8,9,3,"standard","2022-03-21T00:00:00.000Z","[1913,226,342,927,2059]","[13564,13561,13563,12320,13562]","Sova,Omen,Jett,KAY/O,Chamber","Sova,Killjoy,Jett,Skye,Astra",1588
58855,26478,"VCT 2022: APAC Stage 1 Challengers - Group Stage","Icebox",5903,"XERXIA Esports",667,"Onic Esports",2,13,10,6,6,0,0,0,7,4,6,6,2,1,1,6,6,4,7,"standard","2022-03-21T00:00:00.000Z","[6890,671,766,3642,21245]","[9970,3583,3496,3377,3380]","Sova,Killjoy,Viper,Sage,Jett","Sova,Viper,Sage,Jett,Chamber",1588
58854,26478,"VCT 2022: APAC Stage 1 Challengers - Group Stage","Bind",5903,"XERXIA Esports",667,"Onic Esports",1,13,9,8,4,2,1,1,8,4,5,5,0,0,0,5,5,4,8,"standard","2022-03-21T00:00:00.000Z","[6890,21245,3642,766,671]","[3377,3583,3380,3496,9970]","Sova,Jett,Skye,Astra,Chamber","Raze,Sova,Viper,Astra,Chamber",1588
58852,26477,"VCT 2022: APAC Stage 1 Challengers - Group Stage","Ascent",93,"Made in Thailand",225,"CERBERUS Esports",2,13,8,7,5,2,1,1,6,3,7,5,0,0,0,5,7,3,6,"standard","2022-03-21T00:00:00.000Z","[609,2957,157,347,2071]","[917,12,13639,730,502]","Sova,Killjoy,Jett,Astra,KAY/O","Breach,Sova,Omen,Jett,Chamber",1588
58851,26477,"VCT 2022: APAC Stage 1 Challengers - Group Stage","Bind",93,"Made in Thailand",225,"CERBERUS Esports",1,13,3,11,1,1,1,0,11,1,2,2,1,1,0,2,2,1,11,"standard","2022-03-21T00:00:00.000Z","[157,2957,347,609,2071]","[917,12,730,13639,502]","Raze,Viper,Brimstone,Sage,Skye","Breach,Sova,Jett,Astra,Chamber",1588
58764,26446,"VCT North America 2022 - Stage 1 Challengers - Main Event","Fracture",1931,"Version1 (Inactive)",388,"Sentinels",1,13,8,6,6,2,1,1,6,6,7,2,0,0,0,2,7,6,6,"standard","2022-03-21T00:00:00.000Z","[3056,440,3798,7025,3352]","[1614,3033,724,1485,893]","Breach,Raze,Brimstone,Sage,Chamber","Breach,Raze,Viper,Brimstone,Chamber",1588
58763,26446,"VCT North America 2022 - Stage 1 Challengers - Main Event","Ascent",1931,"Version1 (Inactive)",388,"Sentinels",1,13,9,6,6,2,1,1,6,6,7,3,0,0,0,3,7,6,6,"standard","2022-03-20T00:00:00.000Z","[3056,7025,3352,3798,440]","[893,724,3033,1485,1614]","Sova,Killjoy,Jett,Astra,KAY/O","Sova,Killjoy,Jett,Astra,KAY/O",1588
58762,26446,"VCT North America 2022 - Stage 1 Challengers - Main Event","Haven",1931,"Version1 (Inactive)",388,"Sentinels",1,7,13,4,8,1,1,0,4,8,3,5,1,1,0,5,3,8,4,"standard","2022-03-20T00:00:00.000Z","[3056,7025,3798,3352,440]","[893,724,1485,3033,1614]","Breach,Killjoy,Omen,Jett,KAY/O","Sova,Killjoy,Omen,Jett,KAY/O",1588
58736,26433,"VCT North America 2022 - Stage 1 Challengers - Main Event","Breeze",588,"Knights",603,"XSET",1,7,13,5,7,1,1,0,5,7,2,6,1,1,0,6,2,7,5,"standard","2022-03-20T00:00:00.000Z","[3894,2810,3831,3340,835]","[494,3346,3062,1802,3582]","Cypher,Sova,Viper,Jett,KAY/O","Cypher,Sova,Viper,Jett,KAY/O",1588
58735,26433,"VCT North America 2022 - Stage 1 Challengers - Main Event","Split",588,"Knights",603,"XSET",2,8,13,5,7,1,1,0,3,6,5,7,1,1,0,7,5,6,3,"standard","2022-03-20T00:00:00.000Z","[2810,3831,3894,3340,835]","[3582,3062,3346,494,1802]","Breach,Astra,KAY/O,Chamber,Neon","Raze,Viper,Skye,Astra,Chamber",1588
58840,26473,"VCT Korea 2022 - Stage 1 Challengers - Playoffs","Ascent",6510,"HolyMolly",997,"DAMWON Gaming",2,14,12,6,6,1,0,1,7,6,7,6,1,0,1,6,7,6,7,"standard","2022-03-20T00:00:00.000Z","[1810,2908,3186,15725,2508]","[2368,2240,1406,4811,2762]","Killjoy,Sage,Omen,Yoru,KAY/O","Sova,Killjoy,Omen,Jett,KAY/O",1588
58837,26472,"VCT 2022: APAC Stage 1 Challengers - Group Stage","Split",227,"FULL SENSE",212,"Velocity Gaming",1,13,3,9,3,2,1,1,9,3,4,0,0,0,0,0,4,3,9,"standard","2022-03-20T00:00:00.000Z","[2122,2667,2018,531,676]","[927,226,2059,1913,342]","Raze,Cypher,Jett,Skye,Astra","Breach,Raze,Killjoy,Omen,Jett",1588
58839,26473,"VCT Korea 2022 - Stage 1 Challengers - Playoffs","Haven",6510,"HolyMolly",997,"DAMWON Gaming",1,13,4,8,4,1,0,1,8,4,5,0,1,0,1,0,5,4,8,"standard","2022-03-20T00:00:00.000Z","[2508,2908,1810,3186,15725]","[1406,2368,2240,4811,2762]","Breach,Sova,Killjoy,Omen,Jett","Breach,Sova,Killjoy,Jett,Astra",1588
58836,26472,"VCT 2022: APAC Stage 1 Challengers - Group Stage","Haven",227,"FULL SENSE",212,"Velocity Gaming",2,14,12,3,9,1,1,0,10,3,4,9,1,1,0,9,4,3,10,"standard","2022-03-20T00:00:00.000Z","[2122,2018,531,676,2667]","[1913,2059,226,342,927]","Sova,Jett,Skye,Astra,Chamber","Sova,Killjoy,Omen,Jett,KAY/O",1588
58810,26463,"VCT Korea 2022 - Stage 1 Challengers - Playoffs","Split",286,"DRX",5373,"On Sla2ers",1,13,2,10,2,2,1,1,10,2,3,0,0,0,0,0,3,2,10,"standard","2022-03-20T00:00:00.000Z","[1550,452,814,1251,582]","[2904,2151,2009,1075,1199]","Raze,Viper,Sage,Omen,KAY/O","Breach,Killjoy,Omen,Jett,Skye",1588
58809,26463,"VCT Korea 2022 - Stage 1 Challengers - Playoffs","Breeze",286,"DRX",5373,"On Sla2ers",1,13,8,6,6,1,0,1,6,6,7,2,1,0,1,2,7,6,6,"standard","2022-03-20T00:00:00.000Z","[814,452,1550,582,1251]","[2151,1199,2009,1075,2904]","Sova,Viper,Jett,Skye,Chamber","Cypher,Sova,Viper,Jett,KAY/O",1588
58832,26470,"VCT 2022: APAC Stage 1 Challengers - Group Stage","Haven",6635,"Persija Esports",5916,"Bonkers(OCE)",2,15,13,7,5,1,1,0,6,8,9,5,1,1,0,5,9,8,6,"standard","2022-03-20T00:00:00.000Z","[386,6834,3495,2421,3373]","[943,2207,10239,812,2271]","Raze,Sova,Killjoy,Brimstone,Jett","Raze,Sova,Brimstone,Sage,Chamber",1588
58831,26470,"VCT 2022: APAC Stage 1 Challengers - Group Stage","Fracture",6635,"Persija Esports",5916,"Bonkers(OCE)",2,15,13,4,8,0,0,0,10,4,5,9,2,1,1,9,5,4,10,"standard","2022-03-20T00:00:00.000Z","[6834,386,3495,2421,3373]","[812,943,2271,2207,10239]","Breach,Raze,Cypher,Brimstone,Jett","Breach,Raze,Cypher,Viper,Astra",1588
58830,26470,"VCT 2022: APAC Stage 1 Challengers - Group Stage","Bind",6635,"Persija Esports",5916,"Bonkers(OCE)",1,15,17,6,6,2,1,1,8,8,7,9,0,0,0,9,7,8,8,"standard","2022-03-20T00:00:00.000Z","[386,6834,2421,3495,3373]","[2207,10239,812,2271,943]","Raze,Sova,Brimstone,Chamber,Neon","Sova,Brimstone,Skye,Chamber,Neon",1588
58766,26447,"VCT North America 2022 - Stage 1 Challengers - Main Event","Icebox",279,"Luminosity Gaming",5201,"The Guard",2,5,13,3,9,1,1,0,2,4,3,9,1,1,0,9,3,4,2,"standard","2022-03-20T00:00:00.000Z","[2489,1522,905,1801,3345]","[11412,1804,1091,2551,4141]","Sova,Omen,Jett,KAY/O,Chamber","Sova,Viper,Omen,Jett,Chamber",1588
58765,26447,"VCT North America 2022 - Stage 1 Challengers - Main Event","Bind",279,"Luminosity Gaming",5201,"The Guard",2,10,13,6,6,1,1,0,4,7,6,6,1,1,0,6,6,7,4,"standard","2022-03-19T00:00:00.000Z","[1801,2489,1522,3345,905]","[2551,4141,1804,1091,11412]","Raze,Sova,Brimstone,Sage,Chamber","Raze,Viper,Brimstone,Sage,Skye",1588
58734,26432,"VCT North America 2022 - Stage 1 Challengers - Main Event","Ascent",141,"Cloud9",6426,"OpTic Gaming",2,8,13,7,5,1,1,0,1,8,7,5,1,1,0,5,7,8,1,"standard","2022-03-19T00:00:00.000Z","[1961,2213,4639,3599,13591]","[2483,2841,398,2716,3211]","Sova,Killjoy,Omen,Jett,KAY/O","Sova,Killjoy,Brimstone,Jett,KAY/O",1588
58733,26432,"VCT North America 2022 - Stage 1 Challengers - Main Event","Fracture",141,"Cloud9",6426,"OpTic Gaming",2,13,5,8,4,1,1,0,5,1,8,4,1,1,0,4,8,1,5,"standard","2022-03-19T00:00:00.000Z","[1961,13591,4639,2213,3599]","[2841,3211,2483,398,2716]","Breach,Raze,Brimstone,Sage,Chamber","Breach,Raze,Viper,Astra,Chamber",1588
58732,26432,"VCT North America 2022 - Stage 1 Challengers - Main Event","Haven",141,"Cloud9",6426,"OpTic Gaming",1,12,14,8,4,0,0,0,8,5,4,9,2,1,1,9,4,5,8,"standard","2022-03-19T00:00:00.000Z","[1961,2213,4639,3599,13591]","[2841,398,2483,2716,3211]","Breach,Killjoy,Omen,Jett,Skye","Breach,Brimstone,Skye,Chamber,Neon",1588
58816,26465,"VCT Korea 2022 - Stage 1 Challengers - Playoffs","Breeze",1515,"World Game Star",6510,"HolyMolly",2,7,13,4,8,1,0,1,3,5,4,8,1,0,1,8,4,5,3,"standard","2022-03-19T00:00:00.000Z","[293,3522,2650,2687,23167]","[3186,2908,15725,2508,1810]","Sova,Viper,Jett,KAY/O,Chamber","Sova,Viper,Jett,KAY/O,Chamber",1588
58815,26465,"VCT Korea 2022 - Stage 1 Challengers - Playoffs","Bind",1515,"World Game Star",6510,"HolyMolly",1,8,13,7,5,1,1,0,7,5,1,8,1,1,0,8,1,5,7,"standard","2022-03-19T00:00:00.000Z","[293,23167,3522,2687,2650]","[1810,3186,15725,2508,2908]","Sage,Reyna,Omen,Skye,Neon","Viper,Brimstone,Sage,Skye,Chamber",1588
58730,26431,"VCT 2022: APAC Stage 1 Challengers - Group Stage","Ascent",3390,"South Built Esports",679,"Oblivion Force",2,13,10,8,4,1,0,1,5,6,8,4,1,0,1,4,8,6,5,"standard","2022-03-19T00:00:00.000Z","[13564,13561,13563,13562,12320]","[22286,23613,3445,10510,22285]","Sova,Killjoy,Jett,Astra,KAY/O","Sova,Killjoy,Omen,Jett,KAY/O",1588
58814,26464,"VCT Korea 2022 - Stage 1 Challengers - Playoffs","Split",997,"DAMWON Gaming",6366,"Maru Gaming",1,13,7,9,3,1,1,0,9,3,4,4,1,1,0,4,4,3,9,"standard","2022-03-19T00:00:00.000Z","[1406,2368,4811,2762,2240]","[6719,8382,18837,6740,4229]","Viper,Sage,Jett,Astra,Chamber","Viper,Jett,Skye,Astra,Chamber",1588
58729,26431,"VCT 2022: APAC Stage 1 Challengers - Group Stage","Icebox",3390,"South Built Esports",679,"Oblivion Force",1,13,9,5,7,2,1,1,5,7,8,2,0,0,0,2,8,7,5,"standard","2022-03-19T00:00:00.000Z","[13564,16892,12320,13562,13563]","[22286,23613,3445,10510,22285]","Sova,Viper,Sage,Jett,Chamber","Sova,Viper,Sage,Jett,Chamber",1588
58820,26466,"VCT 2022: APAC Stage 1 Challengers - Group Stage","Icebox",184,"Paper Rex",6635,"Persija Esports",1,13,5,10,2,2,1,1,10,2,3,3,0,0,0,3,3,2,10,"standard","2022-03-19T00:00:00.000Z","[8387,8385,432,8386,8388]","[6834,3495,2421,3373,386]","Sova,Viper,Sage,Jett,Chamber","Sova,Viper,Sage,Jett,Chamber",1588
58813,26464,"VCT Korea 2022 - Stage 1 Challengers - Playoffs","Haven",997,"DAMWON Gaming",6366,"Maru Gaming",1,8,13,4,8,0,0,0,4,8,4,5,2,1,1,5,4,8,4,"standard","2022-03-19T00:00:00.000Z","[1406,2368,2240,4811,2762]","[18837,6719,8382,6740,4229]","Breach,Sova,Killjoy,Jett,Astra","Breach,Sova,Jett,Astra,Chamber",1588
58819,26466,"VCT 2022: APAC Stage 1 Challengers - Group Stage","Breeze",184,"Paper Rex",6635,"Persija Esports",1,12,14,8,4,2,1,1,8,5,4,9,0,0,0,9,4,5,8,"standard","2022-03-19T00:00:00.000Z","[8387,8385,8386,432,8388]","[2421,6834,3373,386,3495]","Sova,Viper,Jett,KAY/O,Chamber","Sova,Viper,Jett,Skye,Chamber",1588
58812,26464,"VCT Korea 2022 - Stage 1 Challengers - Playoffs","Ascent",997,"DAMWON Gaming",6366,"Maru Gaming",2,13,8,8,4,2,1,1,5,4,8,4,0,0,0,4,8,4,5,"standard","2022-03-19T00:00:00.000Z","[2368,2240,1406,4811,2762]","[6719,8382,6740,18837,4229]","Sova,Killjoy,Omen,Jett,KAY/O","Sova,Jett,Astra,KAY/O,Chamber",1588
58818,26466,"VCT 2022: APAC Stage 1 Challengers - Group Stage","Fracture",184,"Paper Rex",6635,"Persija Esports",2,13,10,5,7,1,0,1,8,3,5,7,1,0,1,7,5,3,8,"standard","2022-03-19T00:00:00.000Z","[8387,8385,432,8388,8386]","[6834,386,3495,2421,3373]","Breach,Viper,Sage,Chamber,Neon","Breach,Raze,Cypher,Brimstone,Jett",1588
58807,26462,"VCT 2022: APAC Stage 1 Challengers - Group Stage","Haven",93,"Made in Thailand",15,"BOOM Esports",1,10,13,5,7,0,0,0,5,7,5,6,2,1,1,6,5,7,5,"standard","2022-03-19T00:00:00.000Z","[2071,609,2957,157,347]","[1919,3361,3363,217,3365]","Breach,Sova,Killjoy,Jett,Astra","Sova,Killjoy,Jett,Skye,Astra",1588
58806,26462,"VCT 2022: APAC Stage 1 Challengers - Group Stage","Fracture",93,"Made in Thailand",15,"BOOM Esports",2,10,13,4,8,0,0,0,6,5,4,8,2,1,1,8,4,5,6,"standard","2022-03-19T00:00:00.000Z","[609,157,347,2071,2957]","[3365,3363,3361,217,1919]","Breach,Raze,Brimstone,KAY/O,Chamber","Breach,Raze,Cypher,Viper,Astra",1588
58165,26247,"VCT North America 2022 - Stage 1 Challengers - Main Event","Icebox",5201,"The Guard",388,"Sentinels",1,13,1,11,1,2,1,1,11,1,2,0,0,0,0,0,2,1,11,"standard","2022-03-19T00:00:00.000Z","[11412,1804,1091,2551,4141]","[1614,724,1485,3033,893]","Sova,Viper,Omen,Jett,Chamber","Sova,Viper,Omen,Jett,Chamber",1588
58164,26247,"VCT North America 2022 - Stage 1 Challengers - Main Event","Bind",5201,"The Guard",388,"Sentinels",1,13,6,8,4,2,1,1,8,4,5,2,0,0,0,2,5,4,8,"standard","2022-03-18T00:00:00.000Z","[2551,4141,1804,1091,11412]","[1614,893,724,1485,3033]","Raze,Viper,Brimstone,Sage,Skye","Raze,Sova,Viper,Brimstone,Jett",1588
58163,26246,"VCT North America 2022 - Stage 1 Challengers - Main Event","Fracture",1931,"Version1 (Inactive)",279,"Luminosity Gaming",1,13,15,8,4,1,1,0,8,6,5,9,1,1,0,9,5,6,8,"standard","2022-03-18T00:00:00.000Z","[3056,440,3798,7025,3352]","[2489,1801,3345,1522,905]","Breach,Raze,Brimstone,Sage,Chamber","Breach,Raze,Cypher,Brimstone,Chamber",1588
58162,26246,"VCT North America 2022 - Stage 1 Challengers - Main Event","Ascent",1931,"Version1 (Inactive)",279,"Luminosity Gaming",1,13,8,6,6,0,0,0,6,6,7,2,2,1,1,2,7,6,6,"standard","2022-03-18T00:00:00.000Z","[3056,7025,3352,3798,440]","[2489,3345,1522,905,1801]","Sova,Killjoy,Jett,Astra,KAY/O","Sova,Killjoy,Omen,Jett,KAY/O",1588
58161,26246,"VCT North America 2022 - Stage 1 Challengers - Main Event","Bind",1931,"Version1 (Inactive)",279,"Luminosity Gaming",2,10,13,7,5,0,0,0,3,8,7,5,2,1,1,5,7,8,3,"standard","2022-03-18T00:00:00.000Z","[440,3056,7025,3798,3352]","[1801,2489,1522,3345,905]","Raze,Sova,Viper,Brimstone,Jett","Raze,Sova,Brimstone,Sage,Chamber",1588
58604,26390,"VCT EMEA 2022 - Stage 1 Challengers - Group Stage","Breeze",6656,"M3 Champions",2654,"LDN UTD",1,13,1,11,1,2,1,1,11,1,2,0,0,0,0,0,2,1,11,"standard","2022-03-18T00:00:00.000Z","[1964,1081,3135,2528,274]","[426,2305,1894,2561,2571]","Sova,Viper,Jett,Skye,Chamber","Sova,Viper,Jett,Skye,Chamber",1588
58603,26390,"VCT EMEA 2022 - Stage 1 Challengers - Group Stage","Ascent",6656,"M3 Champions",2654,"LDN UTD",2,13,5,9,3,1,0,1,4,2,9,3,1,0,1,3,9,2,4,"standard","2022-03-18T00:00:00.000Z","[2528,274,3135,1081,1964]","[426,2571,1894,2305,2561]","Sova,Killjoy,Jett,Astra,KAY/O","Sova,Killjoy,Jett,Astra,KAY/O",1588
58602,26389,"VCT EMEA 2022 - Stage 1 Challengers - Group Stage","Icebox",4220,"Natus Vincere",17,"FunPlus Phoenix",2,11,13,6,6,2,1,1,5,7,6,6,0,0,0,6,6,7,5,"standard","2022-03-18T00:00:00.000Z","[3003,2279,2983,999,2154]","[2359,2225,7705,1256,3043]","Sova,Viper,Sage,Jett,KAY/O","Sova,Viper,Sage,Reyna,Jett",1588
58601,26389,"VCT EMEA 2022 - Stage 1 Challengers - Group Stage","Breeze",4220,"Natus Vincere",17,"FunPlus Phoenix",2,6,13,2,10,1,1,0,4,3,2,10,1,1,0,10,2,3,4,"standard","2022-03-18T00:00:00.000Z","[2279,3003,2154,999,2983]","[2225,2359,7705,3043,1256]","Cypher,Sova,Viper,Jett,KAY/O","Cypher,Sova,Viper,Jett,KAY/O",1588
58670,26412,"VCT Korea 2022 - Stage 1 Challengers - Playoffs","Icebox",5373,"On Sla2ers",997,"DAMWON Gaming",1,13,8,9,3,1,1,0,9,3,4,5,1,1,0,5,4,3,9,"standard","2022-03-18T00:00:00.000Z","[1199,2151,2009,2904,1075]","[2368,2762,1406,4811,2240]","Sova,Killjoy,Viper,Sage,Jett","Sova,Viper,Sage,Jett,Chamber",1588
58669,26412,"VCT Korea 2022 - Stage 1 Challengers - Playoffs","Haven",5373,"On Sla2ers",997,"DAMWON Gaming",2,11,13,7,5,1,0,1,4,8,7,5,1,0,1,5,7,8,4,"standard","2022-03-18T00:00:00.000Z","[2904,1199,2151,1075,2009]","[1406,2368,2240,4811,2762]","Breach,Sova,Killjoy,Jett,Astra","Breach,Sova,Killjoy,Jett,Astra",1588
58728,26430,"VCT 2022: APAC Stage 1 Challengers - Group Stage","Breeze",667,"Onic Esports",5665,"NAOS Esports",1,13,5,8,4,2,1,1,8,4,5,1,0,0,0,1,5,4,8,"standard","2022-03-18T00:00:00.000Z","[9970,3380,3377,3496,3583]","[1126,19757,8077,13576,340]","Sova,Viper,Jett,KAY/O,Chamber","Sova,Viper,Reyna,Jett,Chamber",1588
58668,26412,"VCT Korea 2022 - Stage 1 Challengers - Playoffs","Ascent",5373,"On Sla2ers",997,"DAMWON Gaming",2,13,10,9,3,1,1,0,4,7,9,3,1,1,0,3,9,7,4,"standard","2022-03-18T00:00:00.000Z","[1199,2151,1075,2009,2904]","[2368,2240,1406,4811,2762]","Sova,Killjoy,Jett,Astra,KAY/O","Sova,Killjoy,Omen,Jett,KAY/O",1588
58727,26430,"VCT 2022: APAC Stage 1 Challengers - Group Stage","Icebox",667,"Onic Esports",5665,"NAOS Esports",1,13,5,7,5,2,1,1,7,5,6,0,0,0,0,0,6,5,7,"standard","2022-03-18T00:00:00.000Z","[9970,3583,3496,3377,3380]","[1126,19757,9613,13576,8077]","Sova,Viper,Sage,Jett,Chamber","Sova,Viper,Sage,Jett,Chamber",1588
58667,26411,"VCT Korea 2022 - Stage 1 Challengers - Playoffs","Haven",286,"DRX",1515,"World Game Star",1,13,2,10,2,2,1,1,10,2,3,0,0,0,0,0,3,2,10,"standard","2022-03-18T00:00:00.000Z","[582,814,1251,452,1550]","[2687,293,23167,3522,2650]","Breach,Sova,Killjoy,Omen,Jett","Breach,Sova,Killjoy,Omen,Jett",1588
58726,26430,"VCT 2022: APAC Stage 1 Challengers - Group Stage","Bind",667,"Onic Esports",5665,"NAOS Esports",2,11,13,8,4,1,1,0,3,9,8,4,1,1,0,4,8,9,3,"standard","2022-03-18T00:00:00.000Z","[3377,3583,3380,3496,9970]","[13576,19757,8077,9613,1126]","Raze,Sova,Viper,Astra,Chamber","Raze,Viper,Brimstone,Sage,Skye",1588
58666,26411,"VCT Korea 2022 - Stage 1 Challengers - Playoffs","Ascent",286,"DRX",1515,"World Game Star",1,13,11,3,9,0,0,0,3,9,10,2,2,1,1,2,10,9,3,"standard","2022-03-18T00:00:00.000Z","[814,1251,452,1550,582]","[293,3522,23167,2650,2687]","Sova,Killjoy,Omen,Jett,KAY/O","Sova,Brimstone,Reyna,Jett,KAY/O",1588
58724,26429,"VCT 2022: APAC Stage 1 Challengers - Group Stage","Haven",3457,"Fancy United Esports",5916,"Bonkers(OCE)",1,10,13,4,8,0,0,0,4,8,6,5,2,1,1,5,6,8,4,"standard","2022-03-18T00:00:00.000Z","[13767,3690,1836,2556,13645]","[943,2207,10239,812,2271]","Breach,Jett,Skye,Astra,Chamber","Raze,Sova,Brimstone,Sage,Chamber",1588
58665,26411,"VCT Korea 2022 - Stage 1 Challengers - Playoffs","Bind",286,"DRX",1515,"World Game Star",2,8,13,3,9,0,0,0,5,4,3,9,2,1,1,9,3,4,5,"standard","2022-03-18T00:00:00.000Z","[1550,814,452,1251,582]","[293,23167,3522,2687,2650]","Raze,Sova,Viper,Brimstone,Skye","Sage,Reyna,Omen,Skye,Neon",1588
58723,26429,"VCT 2022: APAC Stage 1 Challengers - Group Stage","Split",3457,"Fancy United Esports",5916,"Bonkers(OCE)",1,3,13,2,10,0,0,0,2,10,1,3,2,1,1,3,1,10,2,"standard","2022-03-18T00:00:00.000Z","[13767,3690,1836,2556,13645]","[943,2207,2271,812,10239]","Breach,Raze,Omen,Astra,Chamber","Raze,Viper,Sage,Skye,Astra",1588
58722,26428,"VCT 2022: APAC Stage 1 Challengers - Group Stage","Haven",6474,"No Namers",225,"CERBERUS Esports",1,1,13,1,11,0,0,0,1,11,0,2,2,1,1,2,0,11,1,"standard","2022-03-18T00:00:00.000Z","[6616,2275,23031,17060,6610]","[917,12,730,13639,502]","Sova,Brimstone,Jett,Skye,Chamber","Breach,Sova,Jett,Astra,Chamber",1588
58721,26428,"VCT 2022: APAC Stage 1 Challengers - Group Stage","Icebox",6474,"No Namers",225,"CERBERUS Esports",1,11,13,5,7,0,0,0,5,7,6,6,2,1,1,6,6,7,5,"standard","2022-03-18T00:00:00.000Z","[6616,2275,17060,23031,6610]","[12,13639,917,730,502]","Sova,Viper,Sage,Jett,Chamber","Sova,Viper,Sage,Jett,Chamber",1588
58720,26428,"VCT 2022: APAC Stage 1 Challengers - Group Stage","Ascent",6474,"No Namers",225,"CERBERUS Esports",2,13,8,11,1,2,1,1,2,7,11,1,0,0,0,1,11,7,2,"standard","2022-03-18T00:00:00.000Z","[6616,6610,2275,23031,17060]","[917,12,730,13639,502]","Sova,Killjoy,Omen,Jett,KAY/O","Breach,Sova,Jett,Astra,Chamber",1588
58160,26245,"VCT North America 2022 - Stage 1 Challengers - Main Event","Bind",6426,"OpTic Gaming",603,"XSET",1,13,7,6,6,1,0,1,6,6,7,1,1,0,1,1,7,6,6,"standard","2022-03-18T00:00:00.000Z","[3211,2841,398,2483,2716]","[3582,3346,3062,1802,494]","Raze,Viper,Brimstone,Skye,Chamber","Raze,Sova,Viper,Jett,Astra",1588
58159,26245,"VCT North America 2022 - Stage 1 Challengers - Main Event","Ascent",6426,"OpTic Gaming",603,"XSET",1,13,9,8,4,1,0,1,8,4,5,5,1,0,1,5,5,4,8,"standard","2022-03-18T00:00:00.000Z","[2483,2841,398,2716,3211]","[494,3346,3062,3582,1802]","Sova,Killjoy,Brimstone,Jett,KAY/O","Cypher,Sova,Brimstone,Sage,Jett",1588
58158,26245,"VCT North America 2022 - Stage 1 Challengers - Main Event","Split",6426,"OpTic Gaming",603,"XSET",2,4,13,2,10,1,1,0,2,3,2,10,1,1,0,10,2,3,2,"standard","2022-03-17T00:00:00.000Z","[2841,3211,2483,398,2716]","[3582,3062,3346,494,1802]","Breach,Raze,Viper,Omen,Chamber","Raze,Viper,Skye,Astra,Chamber",1588
58157,26244,"VCT North America 2022 - Stage 1 Challengers - Main Event","Haven",141,"Cloud9",588,"Knights",1,13,6,7,5,1,0,1,7,5,6,1,1,0,1,1,6,5,7,"standard","2022-03-17T00:00:00.000Z","[1961,2213,4639,3599,13591]","[2810,3894,3831,3340,835]","Breach,Killjoy,Omen,Jett,Skye","Sova,Killjoy,Omen,Jett,Skye",1588
58156,26244,"VCT North America 2022 - Stage 1 Challengers - Main Event","Breeze",141,"Cloud9",588,"Knights",1,8,13,5,7,1,1,0,5,7,3,6,1,1,0,6,3,7,5,"standard","2022-03-17T00:00:00.000Z","[2213,1961,4639,3599,13591]","[3894,2810,3831,3340,835]","Cypher,Sova,Viper,Jett,KAY/O","Cypher,Sova,Viper,Jett,KAY/O",1588
58155,26244,"VCT North America 2022 - Stage 1 Challengers - Main Event","Ascent",141,"Cloud9",588,"Knights",2,14,12,7,5,0,0,0,6,7,8,5,2,1,1,5,8,7,6,"standard","2022-03-17T00:00:00.000Z","[1961,2213,4639,3599,13591]","[2810,3894,835,3340,3831]","Sova,Killjoy,Omen,Jett,KAY/O","Sova,Killjoy,Sage,Jett,Astra",1588
58600,26389,"VCT EMEA 2022 - Stage 1 Challengers - Group Stage","Ascent",4220,"Natus Vincere",17,"FunPlus Phoenix",1,13,11,8,4,0,0,0,8,4,5,7,2,1,1,7,5,4,8,"standard","2022-03-17T00:00:00.000Z","[2983,2279,999,3003,2154]","[2359,2225,3043,7705,1256]","Sova,Killjoy,Jett,Astra,KAY/O","Sova,Killjoy,Jett,Astra,KAY/O",1588
58598,26388,"VCT EMEA 2022 - Stage 1 Challengers - Group Stage","Breeze",329,"BIG",6656,"M3 Champions",2,8,13,3,9,1,1,0,5,4,3,9,1,1,0,9,3,4,5,"standard","2022-03-17T00:00:00.000Z","[4956,3142,2326,1538,360]","[1964,1081,3135,2528,274]","Cypher,Sova,Viper,Jett,Skye","Sova,Viper,Jett,Skye,Chamber",1588
58597,26388,"VCT EMEA 2022 - Stage 1 Challengers - Group Stage","Split",329,"BIG",6656,"M3 Champions",1,4,13,1,11,2,1,1,1,11,3,2,0,0,0,2,3,11,1,"standard","2022-03-17T00:00:00.000Z","[3142,1538,360,2326,4956]","[2528,1081,1964,274,3135]","Breach,Cypher,Sage,Jett,Astra","Breach,Astra,KAY/O,Chamber,Neon",1588
58568,26380,"VCT 2022: APAC Stage 1 Challengers - Group Stage","Breeze",227,"FULL SENSE",3390,"South Built Esports",2,13,8,5,7,1,1,0,8,1,5,7,1,1,0,7,5,1,8,"standard","2022-03-17T00:00:00.000Z","[2122,2667,2018,531,676]","[13561,12320,16892,13562,13563]","Sova,Viper,Jett,Skye,Chamber","Cypher,Sova,Viper,Jett,KAY/O",1588
58574,26382,"VCT Korea 2022 - Stage 1 Challengers - Playoffs","Bind",997,"DAMWON Gaming",6510,"HolyMolly",2,13,11,8,4,1,0,1,5,7,8,4,1,0,1,4,8,7,5,"standard","2022-03-17T00:00:00.000Z","[4811,1406,2368,2240,2762]","[3186,1810,2908,15725,2508]","Raze,Viper,Sage,Skye,Astra","Sova,Viper,Brimstone,Jett,Skye",1588
58567,26380,"VCT 2022: APAC Stage 1 Challengers - Group Stage","Ascent",227,"FULL SENSE",3390,"South Built Esports",2,13,9,9,3,2,1,1,4,6,9,3,0,0,0,3,9,6,4,"standard","2022-03-17T00:00:00.000Z","[2122,2667,2018,676,531]","[13564,13561,13563,13562,12320]","Sova,Killjoy,Jett,Astra,KAY/O","Sova,Killjoy,Jett,Astra,KAY/O",1588
58573,26382,"VCT Korea 2022 - Stage 1 Challengers - Playoffs","Ascent",997,"DAMWON Gaming",6510,"HolyMolly",2,13,6,9,3,1,0,1,4,3,9,3,1,0,1,3,9,3,4,"standard","2022-03-17T00:00:00.000Z","[2368,2240,1406,4811,2762]","[2908,1810,3186,15725,2508]","Sova,Killjoy,Omen,Jett,KAY/O","Sova,Killjoy,Omen,Jett,KAY/O",1588
58566,26379,"VCT 2022: APAC Stage 1 Challengers - Group Stage","Ascent",5903,"XERXIA Esports",667,"Onic Esports",1,13,3,9,3,2,1,1,9,3,4,0,0,0,0,0,4,3,9,"standard","2022-03-17T00:00:00.000Z","[671,6890,21245,766,3642]","[9970,3583,3496,3377,3380]","Cypher,Sova,Jett,Astra,KAY/O","Sova,Killjoy,Omen,Jett,KAY/O",1588
58565,26379,"VCT 2022: APAC Stage 1 Challengers - Group Stage","Icebox",5903,"XERXIA Esports",667,"Onic Esports",1,14,12,2,10,1,0,1,3,10,11,2,1,0,1,2,11,10,3,"standard","2022-03-17T00:00:00.000Z","[6890,671,766,3642,21245]","[9970,3583,3496,3377,3380]","Sova,Killjoy,Viper,Sage,Jett","Sova,Viper,Sage,Jett,Chamber",1588
58571,26381,"VCT Korea 2022 - Stage 1 Challengers - Playoffs","Split",1515,"World Game Star",6366,"Maru Gaming",2,13,8,10,2,1,0,1,3,6,10,2,1,0,1,2,10,6,3,"standard","2022-03-17T00:00:00.000Z","[293,3522,2650,2687,23167]","[6719,8382,18837,6740,4229]","Sage,Omen,Jett,KAY/O,Chamber","Viper,Jett,Skye,Astra,Chamber",1588
58564,26379,"VCT 2022: APAC Stage 1 Challengers - Group Stage","Breeze",5903,"XERXIA Esports",667,"Onic Esports",1,11,13,5,7,2,1,1,5,7,6,6,0,0,0,6,6,7,5,"standard","2022-03-17T00:00:00.000Z","[671,6890,766,21245,3642]","[9970,3380,3377,3496,3583]","Cypher,Sova,Viper,Jett,KAY/O","Sova,Viper,Jett,KAY/O,Chamber",1588
58570,26381,"VCT Korea 2022 - Stage 1 Challengers - Playoffs","Fracture",1515,"World Game Star",6366,"Maru Gaming",1,13,9,7,5,1,1,0,7,5,6,4,1,1,0,4,6,5,7,"standard","2022-03-17T00:00:00.000Z","[293,2687,3522,23167,2650]","[18837,8382,6740,6719,4229]","Breach,Viper,Brimstone,Chamber,Neon","Breach,Jett,Astra,KAY/O,Chamber",1588
58562,26378,"VCT 2022: APAC Stage 1 Challengers - Group Stage","Icebox",184,"Paper Rex",3457,"Fancy United Esports",1,13,9,11,1,1,1,0,11,1,2,8,1,1,0,8,2,1,11,"standard","2022-03-17T00:00:00.000Z","[8387,8385,432,8386,8388]","[2556,1836,13645,3690,13767]","Sova,Viper,Sage,Jett,Chamber","Sova,Viper,Omen,KAY/O,Chamber",1588
58561,26378,"VCT 2022: APAC Stage 1 Challengers - Group Stage","Haven",184,"Paper Rex",3457,"Fancy United Esports",2,13,5,7,5,2,1,1,6,0,7,5,0,0,0,5,7,0,6,"standard","2022-03-17T00:00:00.000Z","[8387,8388,432,8385,8386]","[13767,3690,1836,2556,13645]","Cypher,Sova,Reyna,Omen,Jett","Breach,Jett,Skye,Astra,Chamber",1588
58559,26377,"VCT 2022: APAC Stage 1 Challengers - Group Stage","Ascent",15,"BOOM Esports",6474,"No Namers",2,13,8,7,5,1,1,0,6,3,7,5,1,1,0,5,7,3,6,"standard","2022-03-17T00:00:00.000Z","[1919,3361,3363,3365,217]","[6616,6610,2275,23031,17060]","Sova,Killjoy,Jett,Astra,KAY/O","Sova,Killjoy,Omen,Jett,KAY/O",1588
58558,26377,"VCT 2022: APAC Stage 1 Challengers - Group Stage","Haven",15,"BOOM Esports",6474,"No Namers",1,13,6,8,4,0,0,0,8,4,5,2,2,1,1,2,5,4,8,"standard","2022-03-17T00:00:00.000Z","[1919,3361,3363,217,3365]","[6616,2275,23031,17060,6610]","Sova,Killjoy,Jett,Skye,Astra","Sova,Brimstone,Jett,Skye,Chamber",1588
58534,26367,"VCT EMEA 2022 - Stage 1 Challengers - Group Stage","Split",386,"Guild Esports",1625,"FNATIC",1,5,13,5,7,0,0,0,5,7,0,6,2,1,1,6,0,7,5,"standard","2022-03-16T00:00:00.000Z","[1834,966,449,2318,2321]","[2937,154,2290,76,2011]","Raze,Cypher,Viper,Skye,Astra","Raze,Viper,Sage,Astra,KAY/O",1588
58533,26367,"VCT EMEA 2022 - Stage 1 Challengers - Group Stage","Bind",386,"Guild Esports",1625,"FNATIC",1,5,13,5,7,0,0,0,5,7,0,6,2,1,1,6,0,7,5,"standard","2022-03-16T00:00:00.000Z","[449,966,1834,2318,2321]","[2937,2290,154,2011,76]","Sova,Viper,Jett,Skye,Astra","Raze,Sova,Viper,Skye,Astra",1588
58532,26367,"VCT EMEA 2022 - Stage 1 Challengers - Group Stage","Haven",386,"Guild Esports",1625,"FNATIC",2,13,5,7,5,1,1,0,6,0,7,5,1,1,0,5,7,0,6,"standard","2022-03-16T00:00:00.000Z","[449,966,2318,1834,2321]","[2011,2290,154,2937,76]","Breach,Sova,Killjoy,Jett,Astra","Breach,Sova,Killjoy,Jett,Astra",1588
58530,26366,"VCT EMEA 2022 - Stage 1 Challengers - Group Stage","Breeze",4220,"Natus Vincere",6656,"M3 Champions",2,9,13,8,4,0,0,0,1,9,8,4,2,1,1,4,8,9,1,"standard","2022-03-16T00:00:00.000Z","[2279,3003,2154,999,2983]","[1964,1081,3135,2528,274]","Cypher,Sova,Viper,Jett,KAY/O","Sova,Viper,Jett,Skye,Chamber",1588
58529,26366,"VCT EMEA 2022 - Stage 1 Challengers - Group Stage","Ascent",4220,"Natus Vincere",6656,"M3 Champions",1,5,13,3,9,1,1,0,3,9,2,4,1,1,0,4,2,9,3,"standard","2022-03-16T00:00:00.000Z","[2983,2279,999,3003,2154]","[2528,274,3135,1081,1964]","Sova,Killjoy,Jett,Astra,KAY/O","Sova,Killjoy,Jett,Astra,KAY/O",1588
58521,26363,"VCT 2022: APAC Stage 1 Challengers - Group Stage","Ascent",212,"Velocity Gaming",679,"Oblivion Force",2,13,10,7,5,0,0,0,6,5,7,5,2,1,1,5,7,5,6,"standard","2022-03-16T00:00:00.000Z","[1913,226,342,927,2059]","[22286,23613,3445,10510,22285]","Sova,Omen,Jett,KAY/O,Chamber","Sova,Killjoy,Omen,Jett,KAY/O",1588
58520,26363,"VCT 2022: APAC Stage 1 Challengers - Group Stage","Icebox",212,"Velocity Gaming",679,"Oblivion Force",1,13,10,10,2,1,1,0,10,2,3,8,1,1,0,8,3,2,10,"standard","2022-03-16T00:00:00.000Z","[1913,226,2059,342,927]","[22286,23613,3445,10510,22285]","Sova,Viper,Sage,Jett,KAY/O","Sova,Viper,Sage,Jett,Chamber",1588
58519,26362,"VCT 2022: APAC Stage 1 Challengers - Group Stage","Ascent",5665,"NAOS Esports",4838,"Bleed Esports",1,4,13,4,8,0,0,0,4,8,0,5,2,1,1,5,0,8,4,"standard","2022-03-16T00:00:00.000Z","[1126,19757,13576,8077,9613]","[2639,6625,645,7877,6639]","Sova,Omen,Jett,KAY/O,Chamber","Breach,Sova,Killjoy,Omen,Jett",1588
58518,26362,"VCT 2022: APAC Stage 1 Challengers - Group Stage","Split",5665,"NAOS Esports",4838,"Bleed Esports",1,11,13,4,8,0,0,0,4,8,7,5,2,1,1,5,7,8,4,"standard","2022-03-16T00:00:00.000Z","[13576,1126,19757,340,8077]","[2639,645,6625,7877,6639]","Raze,Sage,Omen,Chamber,Neon","Raze,Killjoy,Sage,Omen,Jett",1588
58517,26362,"VCT 2022: APAC Stage 1 Challengers - Group Stage","Haven",5665,"NAOS Esports",4838,"Bleed Esports",2,13,6,6,6,2,1,1,7,0,6,6,0,0,0,6,6,0,7,"standard","2022-03-16T00:00:00.000Z","[1126,9613,13576,19757,8077]","[645,6625,7877,6639,2639]","Sova,Killjoy,Jett,Astra,KAY/O","Cypher,Sova,Omen,Jett,Skye",1588
58372,26313,"VCT 2022: APAC Stage 1 Challengers - Group Stage","Bind",6635,"Persija Esports",5916,"Bonkers(OCE)",2,13,2,10,2,2,1,1,3,0,10,2,0,0,0,2,10,0,3,"standard","2022-03-16T00:00:00.000Z","[386,6834,2421,3495,3373]","[2207,10239,812,2271,943]","Raze,Sova,Brimstone,Chamber,Neon","Sova,Brimstone,Skye,Chamber,Neon",1588
58371,26313,"VCT 2022: APAC Stage 1 Challengers - Group Stage","Breeze",6635,"Persija Esports",5916,"Bonkers(OCE)",2,13,3,10,2,1,0,1,3,1,10,2,1,0,1,2,10,1,3,"standard","2022-03-16T00:00:00.000Z","[2421,6834,3373,386,3495]","[2207,10239,2271,812,943]","Sova,Viper,Jett,Skye,Chamber","Sova,Viper,Jett,Skye,Chamber",1588
58370,26313,"VCT 2022: APAC Stage 1 Challengers - Group Stage","Haven",6635,"Persija Esports",5916,"Bonkers(OCE)",1,7,13,5,7,1,1,0,5,7,2,6,1,1,0,6,2,7,5,"standard","2022-03-16T00:00:00.000Z","[3373,3495,6834,2421,386]","[943,2207,10239,812,2271]","Breach,Cypher,Sova,Omen,Jett","Raze,Sova,Brimstone,Sage,Chamber",1588
58369,26312,"VCT 2022: APAC Stage 1 Challengers - Group Stage","Split",93,"Made in Thailand",225,"CERBERUS Esports",1,13,9,3,9,2,1,1,3,9,10,0,0,0,0,0,10,9,3,"standard","2022-03-16T00:00:00.000Z","[157,2957,609,347,2071]","[917,730,12,13639,502]","Raze,Viper,Sage,Astra,KAY/O","Breach,Raze,Sage,Astra,Chamber",1588
58368,26312,"VCT 2022: APAC Stage 1 Challengers - Group Stage","Haven",93,"Made in Thailand",225,"CERBERUS Esports",1,9,13,8,4,0,0,0,8,4,1,9,2,1,1,9,1,4,8,"standard","2022-03-16T00:00:00.000Z","[2071,609,2957,157,347]","[917,12,730,13639,502]","Breach,Sova,Killjoy,Jett,Astra","Breach,Sova,Jett,Astra,Chamber",1588
58367,26312,"VCT 2022: APAC Stage 1 Challengers - Group Stage","Bind",93,"Made in Thailand",225,"CERBERUS Esports",1,13,7,7,5,1,0,1,7,5,6,2,1,0,1,2,6,5,7,"standard","2022-03-16T00:00:00.000Z","[157,2957,347,609,2071]","[917,12,730,13639,502]","Raze,Viper,Brimstone,Sage,Skye","Breach,Sova,Jett,Astra,Chamber",1588
57392,25982,"VCT Brazil 2022 - Stage 1 Challengers 1 - Group Stage","Icebox",72,"INGAMING Esports",5750,"Ninjas in Pyjamas",2,6,13,3,9,0,0,0,3,4,3,9,2,1,1,9,3,4,3,"standard","2022-03-14T00:00:00.000Z","[242,177,4771,9801,462]","[16804,3408,762,2195,3203]","Sova,Killjoy,Viper,Sage,Jett","Sova,Viper,Sage,Reyna,Jett",1588
57391,25982,"VCT Brazil 2022 - Stage 1 Challengers 1 - Group Stage","Breeze",72,"INGAMING Esports",5750,"Ninjas in Pyjamas",1,7,13,5,7,1,1,0,5,7,2,6,1,1,0,6,2,7,5,"standard","2022-03-13T00:00:00.000Z","[177,242,4771,462,9801]","[762,16804,3408,2195,3203]","Cypher,Sova,Viper,Jett,Skye","Cypher,Sova,Viper,Reyna,Jett",1588
58024,26200,"VCT North America 2022 - Stage 1 Challengers - Group Stage","Bind",6426,"OpTic Gaming",588,"Knights",1,13,7,9,3,2,1,1,9,3,4,4,0,0,0,4,4,3,9,"standard","2022-03-13T00:00:00.000Z","[3211,2841,398,2483,2716]","[835,2810,3831,3894,3340]","Raze,Viper,Brimstone,Skye,Chamber","Raze,Sova,Viper,Brimstone,Jett",1588
58023,26200,"VCT North America 2022 - Stage 1 Challengers - Group Stage","Ascent",6426,"OpTic Gaming",588,"Knights",2,13,6,7,5,2,1,1,6,1,7,5,0,0,0,5,7,1,6,"standard","2022-03-13T00:00:00.000Z","[2483,2841,398,2716,3211]","[2810,3894,835,3831,3340]","Sova,Killjoy,Brimstone,Jett,KAY/O","Sova,Killjoy,Sage,Omen,Jett",1588
57387,25980,"VCT Brazil 2022 - Stage 1 Challengers 1 - Group Stage","Breeze",1264,"FURIA",600,"Keyd Stars",2,9,13,4,8,1,0,1,5,5,4,8,1,0,1,8,4,5,5,"standard","2022-03-13T00:00:00.000Z","[2752,18192,2423,6039,2749]","[1661,81,2901,5288,277]","Sova,Viper,Jett,Skye,Chamber","Cypher,Sova,Viper,Jett,Neon",1588
57386,25980,"VCT Brazil 2022 - Stage 1 Challengers 1 - Group Stage","Ascent",1264,"FURIA",600,"Keyd Stars",1,13,11,3,9,1,0,1,3,9,10,2,1,0,1,2,10,9,3,"standard","2022-03-13T00:00:00.000Z","[6039,2752,2749,18192,2423]","[81,1661,277,2901,5288]","Raze,Sova,Omen,KAY/O,Chamber","Sova,Killjoy,Sage,Omen,Jett",1588
58021,26199,"VCT North America 2022 - Stage 1 Challengers - Group Stage","Haven",388,"Sentinels",1931,"Version1 (Inactive)",2,11,13,6,6,1,0,1,5,7,6,6,1,0,1,6,6,7,5,"standard","2022-03-13T00:00:00.000Z","[893,724,1485,3033,1614]","[3056,3798,3352,440,7025]","Sova,Killjoy,Omen,Jett,KAY/O","Breach,Omen,Jett,KAY/O,Chamber",1588
58020,26199,"VCT North America 2022 - Stage 1 Challengers - Group Stage","Ascent",388,"Sentinels",1931,"Version1 (Inactive)",2,4,13,4,8,1,0,1,0,5,4,8,1,0,1,8,4,5,0,"standard","2022-03-13T00:00:00.000Z","[893,724,1485,3033,1614]","[3056,7025,3352,3798,440]","Sova,Killjoy,Omen,Jett,KAY/O","Sova,Killjoy,Jett,Astra,KAY/O",1588
58154,26243,"VCT EMEA 2022 - Stage 1 Challengers - Group Stage","Ascent",520,"BBL Esports",2597,"Acend",2,13,6,7,5,1,1,0,6,1,7,5,1,1,0,5,7,1,6,"standard","2022-03-13T00:00:00.000Z","[2864,1749,9643,1852,3152]","[1334,3208,732,691,509]","Sova,Killjoy,Jett,Astra,KAY/O","Sova,Killjoy,Jett,Astra,KAY/O",1588
57385,25980,"VCT Brazil 2022 - Stage 1 Challengers 1 - Group Stage","Icebox",1264,"FURIA",600,"Keyd Stars",1,13,15,6,6,1,0,1,6,8,7,7,1,0,1,7,7,8,6,"standard","2022-03-13T00:00:00.000Z","[2752,18192,2749,6039,2423]","[81,2901,1661,5288,277]","Sova,Sage,Reyna,Omen,Chamber","Sova,Viper,Sage,Jett,Chamber",1588
58324,26298,"VCT LATAM South 2022 - Stage 1 Challengers 1 - Play In","Haven",976,"KRÜ Esports",683,"9z Team",2,13,4,10,2,2,1,1,3,2,10,2,0,0,0,2,10,2,3,"standard","2022-03-13T00:00:00.000Z","[4712,4710,1725,3535,2532]","[3510,1376,855,9905,3506]","Cypher,Sova,Phoenix,Omen,Jett","Breach,Sova,Killjoy,Omen,Jett",1588
58153,26243,"VCT EMEA 2022 - Stage 1 Challengers - Group Stage","Split",520,"BBL Esports",2597,"Acend",2,11,13,3,9,1,1,0,8,4,3,9,1,1,0,9,3,4,8,"standard","2022-03-13T00:00:00.000Z","[3152,1749,2864,9643,1852]","[509,3208,691,1334,732]","Breach,Cypher,Sage,Jett,Astra","Raze,Cypher,Sage,Omen,Jett",1588
58323,26298,"VCT LATAM South 2022 - Stage 1 Challengers 1 - Play In","Split",976,"KRÜ Esports",683,"9z Team",1,13,3,10,2,2,1,1,10,2,3,1,0,0,0,1,3,2,10,"standard","2022-03-13T00:00:00.000Z","[1725,4712,4710,3535,2532]","[1376,855,9905,3510,3506]","Raze,Cypher,Sage,Omen,Jett","Breach,Raze,Omen,Skye,Chamber",1588
58147,26241,"VCT EMEA 2022 - Stage 1 Challengers - Group Stage","Split",329,"BIG",224,"Team Liquid",2,6,13,5,7,0,0,0,1,6,5,7,2,1,1,7,5,6,1,"standard","2022-03-13T00:00:00.000Z","[3142,1538,360,2326,4956]","[10211,2056,17788,1690,1403]","Breach,Cypher,Sage,Jett,Astra","Breach,Raze,Cypher,Sage,Astra",1588
58152,26243,"VCT EMEA 2022 - Stage 1 Challengers - Group Stage","Haven",520,"BBL Esports",2597,"Acend",1,13,6,8,4,2,1,1,8,4,5,2,0,0,0,2,5,4,8,"standard","2022-03-13T00:00:00.000Z","[3152,2864,1749,9643,1852]","[1334,732,691,3208,509]","Breach,Sova,Killjoy,Jett,Astra","Killjoy,Jett,Skye,Astra,KAY/O",1588
58146,26241,"VCT EMEA 2022 - Stage 1 Challengers - Group Stage","Bind",329,"BIG",224,"Team Liquid",2,12,14,3,9,1,1,0,9,4,3,10,1,1,0,10,3,4,9,"standard","2022-03-13T00:00:00.000Z","[1538,3142,2326,360,4956]","[10211,1403,1690,17788,2056]","Raze,Sova,Viper,Skye,Astra","Sova,Astra,KAY/O,Chamber,Neon",1588
58145,26240,"VCT EMEA 2022 - Stage 1 Challengers - Group Stage","Ascent",2654,"LDN UTD",17,"FunPlus Phoenix",2,13,10,5,7,2,1,1,8,3,5,7,0,0,0,7,5,3,8,"standard","2022-03-13T00:00:00.000Z","[426,2571,1894,2305,2561]","[2359,2225,3043,7705,1256]","Sova,Killjoy,Jett,Astra,KAY/O","Sova,Killjoy,Jett,Astra,KAY/O",1588
58150,26242,"VCT EMEA 2022 - Stage 1 Challengers - Group Stage","Icebox",194,"G2 Esports (Inactive)",386,"Guild Esports",1,13,7,9,3,0,0,0,9,3,4,4,2,1,1,4,4,3,9,"standard","2022-03-13T00:00:00.000Z","[1826,2377,2769,2594,2940]","[449,2321,2318,1834,966]","Sova,Killjoy,Viper,Sage,Jett","Sova,Viper,Sage,Jett,KAY/O",1588
58144,26240,"VCT EMEA 2022 - Stage 1 Challengers - Group Stage","Fracture",2654,"LDN UTD",17,"FunPlus Phoenix",2,5,13,3,9,1,1,0,2,4,3,9,1,1,0,9,3,4,2,"standard","2022-03-13T00:00:00.000Z","[426,2561,2571,2305,1894]","[3043,1256,2225,7705,2359]","Breach,Raze,Cypher,Viper,Jett","Breach,Raze,Cypher,Viper,Astra",1588
58143,26240,"VCT EMEA 2022 - Stage 1 Challengers - Group Stage","Haven",2654,"LDN UTD",17,"FunPlus Phoenix",2,13,10,8,4,0,0,0,5,6,8,4,2,1,1,4,8,6,5,"standard","2022-03-13T00:00:00.000Z","[426,2561,2571,1894,2305]","[2359,2225,3043,7705,1256]","Breach,Sova,Killjoy,Jett,Astra","Sova,Killjoy,Jett,Astra,KAY/O",1588
58149,26242,"VCT EMEA 2022 - Stage 1 Challengers - Group Stage","Bind",194,"G2 Esports (Inactive)",386,"Guild Esports",2,13,9,6,6,0,0,0,7,3,6,6,2,1,1,6,6,3,7,"standard","2022-03-13T00:00:00.000Z","[1826,2377,2594,2769,2940]","[449,966,1834,2318,2321]","Raze,Viper,Skye,Astra,Chamber","Sova,Viper,Jett,Skye,Astra",1588
58141,26239,"VCT Korea 2022 - Stage 1 Challengers : Group Stage","Bind",6368,"Team T5",6366,"Maru Gaming",1,9,13,2,10,1,0,1,2,10,7,3,1,0,1,3,7,10,2,"standard","2022-03-13T00:00:00.000Z","[6595,6549,6546,8058,1512]","[6719,8382,18837,6740,4229]","Sova,Viper,Jett,Skye,Astra","Viper,Jett,Skye,Astra,Chamber",1588
58140,26239,"VCT Korea 2022 - Stage 1 Challengers : Group Stage","Ascent",6368,"Team T5",6366,"Maru Gaming",1,11,13,5,7,2,1,1,5,7,6,6,0,0,0,6,6,7,5,"standard","2022-03-13T00:00:00.000Z","[6595,6549,1512,6546,8058]","[6719,8382,6740,18837,4229]","Sova,Killjoy,Omen,Jett,KAY/O","Sova,Jett,Astra,KAY/O,Chamber",1588
58138,26238,"VCT Korea 2022 - Stage 1 Challengers : Group Stage","Icebox",1515,"World Game Star",5373,"On Sla2ers",2,13,11,6,6,1,0,1,7,5,6,6,1,0,1,6,6,5,7,"standard","2022-03-13T00:00:00.000Z","[293,3522,2687,2650,23167]","[1199,2151,2009,2904,1075]","Sova,Viper,Sage,Jett,Chamber","Sova,Killjoy,Viper,Sage,Jett",1588
58137,26238,"VCT Korea 2022 - Stage 1 Challengers : Group Stage","Fracture",1515,"World Game Star",5373,"On Sla2ers",2,18,16,5,7,1,1,0,11,6,7,10,1,1,0,10,7,6,11,"standard","2022-03-13T00:00:00.000Z","[293,2687,3522,23167,2650]","[2904,1075,2151,2009,1199]","Breach,Viper,Astra,Chamber,Neon","Breach,Raze,Viper,Astra,Chamber",1588
58018,26198,"VCT North America 2022 - Stage 1 Challengers - Group Stage","Split",603,"XSET",279,"Luminosity Gaming",2,13,11,7,5,1,0,1,6,6,7,5,1,0,1,5,7,6,6,"standard","2022-03-13T00:00:00.000Z","[3582,3062,3346,494,1802]","[1801,3345,905,1522,2489]","Raze,Viper,Skye,Astra,Chamber","Raze,Cypher,Sage,Omen,Skye",1588
58017,26198,"VCT North America 2022 - Stage 1 Challengers - Group Stage","Breeze",603,"XSET",279,"Luminosity Gaming",1,13,5,9,3,1,1,0,9,3,4,2,1,1,0,2,4,3,9,"standard","2022-03-12T00:00:00.000Z","[3346,3062,1802,494,3582]","[3345,2489,1522,905,1801]","Sova,Viper,Jett,Astra,KAY/O","Cypher,Sova,Viper,Jett,KAY/O",1588
57389,25981,"VCT Brazil 2022 - Stage 1 Challengers 1 - Group Stage","Icebox",53,"Team Vikings",6344,"LOUD",1,4,13,2,10,1,0,1,2,10,2,3,1,0,1,3,2,10,2,"standard","2022-03-12T00:00:00.000Z","[1159,13153,181,2607,2894]","[2294,4746,6037,4748,2895]","Sova,Killjoy,Viper,Omen,Jett","Sova,Viper,Sage,Jett,KAY/O",1588
57388,25981,"VCT Brazil 2022 - Stage 1 Challengers 1 - Group Stage","Ascent",53,"Team Vikings",6344,"LOUD",2,4,13,4,8,0,0,0,0,5,4,8,2,1,1,8,4,5,0,"standard","2022-03-12T00:00:00.000Z","[181,1159,13153,2607,2894]","[2294,4746,6037,4748,2895]","Breach,Sova,Killjoy,Omen,Jett","Sova,Killjoy,Omen,Jett,KAY/O",1588
58015,26197,"VCT North America 2022 - Stage 1 Challengers - Group Stage","Haven",305,"100 Thieves",1448,"Evil Geniuses",1,14,12,10,2,1,1,0,11,2,3,10,1,1,0,10,3,2,11,"standard","2022-03-12T00:00:00.000Z","[1012,355,1175,763,10253]","[102,722,11672,4157,1023]","Breach,Sova,Omen,Jett,Chamber","Breach,Sova,Brimstone,Jett,Chamber",1588
57859,26144,"VCT LATAM South 2022 - Stage 1 Challengers 1 - Play In","Breeze",976,"KRÜ Esports",738,"Leviatán",2,8,13,7,5,0,0,0,1,8,7,5,2,1,1,5,7,8,1,"standard","2022-03-12T00:00:00.000Z","[3539,3535,4710,4712,2532]","[3531,3421,3532,6414,3555]","Sova,Viper,Jett,KAY/O,Chamber","Sova,Viper,Jett,KAY/O,Chamber",1588
57383,25979,"VCT Brazil 2022 - Stage 1 Challengers 1 - Group Stage","Bind",5747,"TBK Esports",319,"Liberty",2,13,4,9,3,1,0,1,4,1,9,3,1,0,1,3,9,1,4,"standard","2022-03-12T00:00:00.000Z","[2366,9831,2457,1506,5580]","[986,4745,2054,937,2927]","Raze,Brimstone,Sage,Reyna,Skye","Breach,Raze,Sova,Omen,Skye",1588
57858,26144,"VCT LATAM South 2022 - Stage 1 Challengers 1 - Play In","Ascent",976,"KRÜ Esports",738,"Leviatán",1,2,13,2,10,0,0,0,2,10,0,3,2,1,1,3,0,10,2,"standard","2022-03-12T00:00:00.000Z","[3539,4712,4710,3535,2532]","[3531,3555,3421,3532,6414]","Sova,Killjoy,Reyna,Omen,Jett","Sova,Killjoy,Omen,Jett,KAY/O",1588
58014,26197,"VCT North America 2022 - Stage 1 Challengers - Group Stage","Breeze",305,"100 Thieves",1448,"Evil Geniuses",2,13,11,6,6,1,1,0,7,5,6,6,1,1,0,6,6,5,7,"standard","2022-03-12T00:00:00.000Z","[355,1175,763,1012,10253]","[102,11672,1023,722,4157]","Sova,Viper,Reyna,KAY/O,Chamber","Sova,Viper,Jett,KAY/O,Chamber",1588
57911,26162,"VCT EMEA 2022 - Stage 1 Challengers - Group Stage","Ascent",4220,"Natus Vincere",329,"BIG",2,13,10,9,3,1,0,1,4,7,9,3,1,0,1,3,9,7,4,"standard","2022-03-12T00:00:00.000Z","[2983,2279,999,3003,2154]","[4956,3142,1538,2326,360]","Sova,Killjoy,Jett,Astra,KAY/O","Cypher,Sova,Jett,Astra,KAY/O",1588
57382,25979,"VCT Brazil 2022 - Stage 1 Challengers 1 - Group Stage","Breeze",5747,"TBK Esports",319,"Liberty",2,13,9,6,6,2,1,1,7,3,6,6,0,0,0,6,6,3,7,"standard","2022-03-12T00:00:00.000Z","[5580,2457,9831,1506,2366]","[2927,986,937,4745,2054]","Sova,Viper,Omen,Chamber,Neon","Sova,Viper,Jett,KAY/O,Chamber",1588
57862,26145,"VCT LATAM South 2022 - Stage 1 Challengers 1 - Play In","Bind",1503,"Movistar Optix",683,"9z Team",1,8,13,5,7,1,1,0,5,7,3,6,1,1,0,6,3,7,5,"standard","2022-03-12T00:00:00.000Z","[14764,3409,3411,4619,14762]","[3510,855,1376,9905,3506]","Raze,Viper,Brimstone,Sage,Skye","Breach,Raze,Sova,Brimstone,Sage",1588
57910,26162,"VCT EMEA 2022 - Stage 1 Challengers - Group Stage","Bind",4220,"Natus Vincere",329,"BIG",2,18,16,5,7,0,0,0,10,7,8,9,2,1,1,9,8,7,10,"standard","2022-03-12T00:00:00.000Z","[2983,2279,999,3003,2154]","[1538,3142,2326,360,4956]","Sova,Viper,Jett,Astra,KAY/O","Raze,Sova,Viper,Skye,Astra",1588
57861,26145,"VCT LATAM South 2022 - Stage 1 Challengers 1 - Play In","Haven",1503,"Movistar Optix",683,"9z Team",2,9,13,7,5,0,0,0,2,8,7,5,2,1,1,5,7,8,2,"standard","2022-03-12T00:00:00.000Z","[14762,3409,4619,3411,14764]","[3510,1376,855,9905,3506]","Breach,Sova,Omen,Chamber,Neon","Breach,Sova,Killjoy,Omen,Jett",1588
57909,26162,"VCT EMEA 2022 - Stage 1 Challengers - Group Stage","Icebox",4220,"Natus Vincere",329,"BIG",1,6,13,4,8,0,0,0,4,8,2,5,2,1,1,5,2,8,4,"standard","2022-03-12T00:00:00.000Z","[3003,2279,2983,999,2154]","[3142,2326,4956,1538,360]","Sova,Viper,Sage,Jett,KAY/O","Sova,Viper,Sage,Jett,Chamber",1588
57916,26164,"VCT EMEA 2022 - Stage 1 Challengers - Group Stage","Ascent",2597,"Acend",1625,"FNATIC",1,10,13,6,6,2,1,1,6,6,4,7,0,0,0,7,4,6,6,"standard","2022-03-12T00:00:00.000Z","[1334,3208,732,691,2391]","[2290,154,2937,76,2011]","Sova,Killjoy,Jett,Astra,KAY/O","Sova,Killjoy,Jett,Astra,KAY/O",1588
57915,26164,"VCT EMEA 2022 - Stage 1 Challengers - Group Stage","Haven",2597,"Acend",1625,"FNATIC",1,4,13,2,10,1,0,1,2,10,2,3,1,0,1,3,2,10,2,"standard","2022-03-12T00:00:00.000Z","[1334,732,691,3208,2391]","[2011,2290,154,2937,76]","Killjoy,Jett,Skye,Astra,KAY/O","Breach,Sova,Killjoy,Jett,Astra",1588
57914,26163,"VCT EMEA 2022 - Stage 1 Challengers - Group Stage","Icebox",386,"Guild Esports",3540,"SuperMassive",1,19,17,4,8,1,0,1,8,10,11,7,1,0,1,7,11,10,8,"standard","2022-03-12T00:00:00.000Z","[449,2321,2318,1834,966]","[9642,2969,3233,3725,9640]","Sova,Viper,Sage,Jett,KAY/O","Sova,Killjoy,Viper,Sage,Jett",1588
57913,26163,"VCT EMEA 2022 - Stage 1 Challengers - Group Stage","Breeze",386,"Guild Esports",3540,"SuperMassive",1,13,1,11,1,2,1,1,11,1,2,0,0,0,0,0,2,1,11,"standard","2022-03-12T00:00:00.000Z","[966,449,2321,1834,2318]","[9642,3233,9640,3725,2969]","Cypher,Sova,Viper,Jett,Skye","Sova,Viper,Jett,Skye,Chamber",1588
57907,26161,"VCT EMEA 2022 - Stage 1 Challengers - Group Stage","Haven",17,"FunPlus Phoenix",224,"Team Liquid",1,13,7,10,2,2,1,1,10,2,3,5,0,0,0,5,3,2,10,,"2022-03-12T00:00:00.000Z","[2359,2225,3043,7705,1256]","[1690,1403,17788,10211,2056]","Sova,Killjoy,Jett,Astra,KAY/O","Skye,Astra,KAY/O,Chamber,Neon",1588
57912,26163,"VCT EMEA 2022 - Stage 1 Challengers - Group Stage","Haven",386,"Guild Esports",3540,"SuperMassive",2,10,13,5,7,1,1,0,5,6,5,7,1,1,0,7,5,6,5,"standard","2022-03-12T00:00:00.000Z","[449,1834,2318,2321,966]","[3725,9642,2969,9640,3233]","Sova,Jett,Skye,Astra,Chamber","Breach,Sova,Killjoy,Jett,Astra",1588
57906,26161,"VCT EMEA 2022 - Stage 1 Challengers - Group Stage","Ascent",17,"FunPlus Phoenix",224,"Team Liquid",2,13,6,10,2,0,0,0,3,4,10,2,2,1,1,2,10,4,3,"standard","2022-03-12T00:00:00.000Z","[2359,2225,3043,7705,1256]","[2056,17788,10211,1403,1690]","Sova,Killjoy,Jett,Astra,KAY/O","Sova,Killjoy,Jett,Astra,KAY/O",1588
58135,26237,"VCT Korea 2022 - Stage 1 Challengers : Group Stage","Haven",6510,"HolyMolly",6360,"Desperado",1,13,8,6,6,2,1,1,6,6,7,2,0,0,0,2,7,6,6,"standard","2022-03-12T00:00:00.000Z","[2508,3186,1810,2908,15725]","[3523,6690,19177,227,18866]","Breach,Sova,Killjoy,Jett,Astra","Raze,Killjoy,Reyna,Jett,Astra",1588
58134,26237,"VCT Korea 2022 - Stage 1 Challengers : Group Stage","Breeze",6510,"HolyMolly",6360,"Desperado",2,13,9,9,3,1,0,1,4,6,9,3,1,0,1,3,9,6,4,"standard","2022-03-12T00:00:00.000Z","[3186,2908,15725,2508,1810]","[3523,18866,227,19177,6690]","Sova,Viper,Jett,KAY/O,Chamber","Sova,Viper,Reyna,Jett,Chamber",1588
58132,26236,"VCT Korea 2022 - Stage 1 Challengers : Group Stage","Split",997,"DAMWON Gaming",286,"DRX",2,6,13,4,8,1,0,1,2,5,4,8,1,0,1,8,4,5,2,"standard","2022-03-12T00:00:00.000Z","[1406,2368,4811,2762,2240]","[452,814,1550,582,1251]","Viper,Sage,Jett,Astra,Chamber","Viper,Sage,Jett,Skye,Astra",1588
58131,26236,"VCT Korea 2022 - Stage 1 Challengers : Group Stage","Bind",997,"DAMWON Gaming",286,"DRX",2,9,13,5,7,1,0,1,4,6,5,7,1,0,1,7,5,6,4,"standard","2022-03-12T00:00:00.000Z","[1406,2240,4811,2368,2762]","[1550,814,452,582,1251]","Viper,Sage,Jett,Skye,Astra","Raze,Sova,Viper,Skye,Astra",1588
57380,25978,"VCT North America 2022 - Stage 1 Challengers - Group Stage","Haven",116,"NRG Esports",281,"Rise",2,13,4,8,4,2,1,1,5,0,8,4,0,0,0,4,8,0,5,"standard","2022-03-12T00:00:00.000Z","[1597,493,1232,165,1763]","[1990,269,1994,2105,2091]","Sova,Killjoy,Omen,Yoru,KAY/O","Cypher,Sova,Omen,Jett,KAY/O",1588
57379,25978,"VCT North America 2022 - Stage 1 Challengers - Group Stage","Fracture",116,"NRG Esports",281,"Rise",1,13,7,6,6,1,0,1,6,6,7,1,1,0,1,1,7,6,6,"standard","2022-03-11T00:00:00.000Z","[1597,1763,493,1232,165]","[269,2091,1994,1990,2105]","Breach,Raze,Viper,Astra,Chamber","Breach,Raze,Viper,Astra,Chamber",1588
57378,25977,"VCT North America 2022 - Stage 1 Challengers - Group Stage","Haven",141,"Cloud9",5201,"The Guard",1,13,2,10,2,2,1,1,10,2,3,0,0,0,0,0,3,2,10,"standard","2022-03-11T00:00:00.000Z","[1961,2213,4639,3599,13591]","[11412,4141,1804,2551,1091]","Breach,Killjoy,Omen,Jett,Skye","Sova,Killjoy,Omen,Jett,Skye",1588
57377,25977,"VCT North America 2022 - Stage 1 Challengers - Group Stage","Ascent",141,"Cloud9",5201,"The Guard",1,13,4,9,3,2,1,1,9,3,4,1,0,0,0,1,4,3,9,"standard","2022-03-11T00:00:00.000Z","[1961,2213,4639,3599,13591]","[11412,4141,2551,1804,1091]","Sova,Killjoy,Omen,Jett,KAY/O","Sova,Killjoy,Jett,Astra,KAY/O",1588
57376,25977,"VCT North America 2022 - Stage 1 Challengers - Group Stage","Bind",141,"Cloud9",5201,"The Guard",2,7,13,4,8,0,0,0,3,5,4,8,2,1,1,8,4,5,3,"standard","2022-03-11T00:00:00.000Z","[3599,13591,1961,4639,2213]","[2551,4141,1804,1091,11412]","Breach,Raze,Sova,Viper,Brimstone","Raze,Viper,Brimstone,Sage,Skye",1588
57904,26160,"VCT EMEA 2022 - Stage 1 Challengers - Group Stage","Split",194,"G2 Esports (Inactive)",520,"BBL Esports",2,13,3,9,3,2,1,1,4,0,9,3,0,0,0,3,9,0,4,"standard","2022-03-11T00:00:00.000Z","[1826,2377,2594,2769,2940]","[3152,9643,1749,2864,1852]","Raze,Viper,Skye,Astra,Chamber","Breach,Raze,Cypher,Sage,Astra",1588
57903,26160,"VCT EMEA 2022 - Stage 1 Challengers - Group Stage","Icebox",194,"G2 Esports (Inactive)",520,"BBL Esports",1,13,7,7,5,2,1,1,7,5,6,2,0,0,0,2,6,5,7,"standard","2022-03-11T00:00:00.000Z","[1826,2377,2769,2594,2940]","[2864,3152,1749,1852,9643]","Sova,Killjoy,Viper,Sage,Jett","Sova,Viper,Sage,Reyna,Jett",1588
57901,26159,"VCT EMEA 2022 - Stage 1 Challengers - Group Stage","Ascent",3540,"SuperMassive",1625,"FNATIC",1,4,13,3,9,1,1,0,3,9,1,4,1,1,0,4,1,9,3,"standard","2022-03-11T00:00:00.000Z","[9642,2969,3725,9640,3233]","[2290,154,2937,76,2011]","Sova,Killjoy,Sage,Jett,Astra","Sova,Killjoy,Jett,Astra,KAY/O",1588
57900,26159,"VCT EMEA 2022 - Stage 1 Challengers - Group Stage","Icebox",3540,"SuperMassive",1625,"FNATIC",2,9,13,5,7,1,0,1,4,6,5,7,1,0,1,7,5,6,4,"standard","2022-03-11T00:00:00.000Z","[9642,2969,3233,3725,9640]","[2290,154,76,2011,2937]","Sova,Killjoy,Viper,Sage,Jett","Sova,Killjoy,Viper,Sage,Jett",1588
58130,26235,"VCT Korea 2022 - Stage 1 Challengers : Group Stage","Fracture",1515,"World Game Star",6366,"Maru Gaming",2,15,13,9,3,1,0,1,5,9,10,4,1,0,1,4,10,9,5,"standard","2022-03-11T00:00:00.000Z","[293,2687,3522,23167,2650]","[18837,8382,6740,6719,4229]","Breach,Viper,Astra,Chamber,Neon","Breach,Jett,Astra,KAY/O,Chamber",1588
58129,26235,"VCT Korea 2022 - Stage 1 Challengers : Group Stage","Ascent",1515,"World Game Star",6366,"Maru Gaming",2,7,13,5,7,0,0,0,2,6,5,7,2,1,1,7,5,6,2,"standard","2022-03-11T00:00:00.000Z","[293,2650,3522,2687,23167]","[6719,8382,6740,18837,4229]","Sova,Jett,Astra,KAY/O,Chamber","Sova,Jett,Astra,KAY/O,Chamber",1588
58128,26235,"VCT Korea 2022 - Stage 1 Challengers : Group Stage","Haven",1515,"World Game Star",6366,"Maru Gaming",1,13,9,9,3,1,0,1,9,3,4,6,1,0,1,6,4,3,9,"standard","2022-03-11T00:00:00.000Z","[293,23167,2650,3522,2687]","[18837,6719,8382,6740,4229]","Sova,Killjoy,Jett,Astra,KAY/O","Breach,Sova,Jett,Astra,Chamber",1588
58124,26233,"VCT Korea 2022 - Stage 1 Challengers : Group Stage","Haven",6368,"Team T5",5373,"On Sla2ers",2,3,13,1,11,0,0,0,2,2,1,11,2,1,1,11,1,2,2,"standard","2022-03-11T00:00:00.000Z","[6595,6546,1512,8058,6549]","[2904,1199,2151,1075,2009]","Sova,Jett,Astra,KAY/O,Chamber","Breach,Sova,Killjoy,Jett,Astra",1588
58123,26233,"VCT Korea 2022 - Stage 1 Challengers : Group Stage","Bind",6368,"Team T5",5373,"On Sla2ers",2,6,13,4,8,1,0,1,2,5,4,8,1,0,1,8,4,5,2,"standard","2022-03-11T00:00:00.000Z","[6595,6549,6546,8058,1512]","[1199,2151,1075,2904,2009]","Sova,Viper,Jett,Skye,Astra","Sova,Viper,Jett,Skye,Astra",1588
58122,26233,"VCT Korea 2022 - Stage 1 Challengers : Group Stage","Icebox",6368,"Team T5",5373,"On Sla2ers",2,13,6,8,4,2,1,1,5,2,8,4,0,0,0,4,8,2,5,"standard","2022-03-11T00:00:00.000Z","[8058,6549,1512,6595,6546]","[1199,2151,2009,2904,1075]","Sova,Viper,Sage,Reyna,Jett","Sova,Killjoy,Viper,Sage,Jett",1588
58120,26232,"VCT Korea 2022 - Stage 1 Challengers : Group Stage","Split",6510,"HolyMolly",286,"DRX",1,1,13,1,11,0,0,0,1,11,0,2,2,1,1,2,0,11,1,"standard","2022-03-10T00:00:00.000Z","[2908,1810,3186,15725,2508]","[452,814,1550,582,1251]","Raze,Viper,Sage,Astra,KAY/O","Viper,Sage,Jett,Skye,Astra",1588
58119,26232,"VCT Korea 2022 - Stage 1 Challengers : Group Stage","Ascent",6510,"HolyMolly",286,"DRX",2,9,13,3,9,0,0,0,6,4,3,9,2,1,1,9,3,4,6,"standard","2022-03-10T00:00:00.000Z","[3186,1810,2908,15725,2508]","[814,1550,582,452,1251]","Sova,Killjoy,Jett,Astra,KAY/O","Sova,Jett,Skye,Astra,Chamber",1588
58118,26231,"VCT Korea 2022 - Stage 1 Challengers : Group Stage","Split",997,"DAMWON Gaming",6360,"Desperado",1,13,10,6,6,0,0,0,6,6,7,4,2,1,1,4,7,6,6,"standard","2022-03-10T00:00:00.000Z","[1406,2368,4811,4812,2240]","[227,19177,6690,18866,3523]","Viper,Sage,Jett,Astra,Chamber","Reyna,Jett,Skye,Astra,KAY/O",1588
58117,26231,"VCT Korea 2022 - Stage 1 Challengers : Group Stage","Ascent",997,"DAMWON Gaming",6360,"Desperado",1,13,5,9,3,2,1,1,9,3,4,2,0,0,0,2,4,3,9,"standard","2022-03-10T00:00:00.000Z","[4812,2368,1406,4811,2240]","[6690,3523,19177,227,18866]","Sova,Killjoy,Omen,Jett,KAY/O","Sova,Sage,Reyna,Jett,Astra",1588
58116,26231,"VCT Korea 2022 - Stage 1 Challengers : Group Stage","Bind",997,"DAMWON Gaming",6360,"Desperado",2,9,13,1,11,1,1,0,8,2,1,11,1,1,0,11,1,2,8,"standard","2022-03-10T00:00:00.000Z","[4811,1406,4812,2240,2368]","[6690,19177,227,18866,3523]","Raze,Viper,Brimstone,Sage,Skye","Sova,Reyna,Jett,Astra,Neon",1588
57292,25946,"VCT North America 2022 - Stage 1 Challengers - Group Stage","Icebox",6426,"OpTic Gaming",1931,"Version1 (Inactive)",1,5,13,4,8,1,0,1,4,8,1,5,1,0,1,5,1,8,4,"standard","2022-03-07T00:00:00.000Z","[2483,398,2841,3211,2716]","[3056,3798,440,3352,7025]","Sova,Viper,Sage,KAY/O,Chamber","Sova,Viper,Sage,Jett,Chamber",1588
57291,25946,"VCT North America 2022 - Stage 1 Challengers - Group Stage","Haven",6426,"OpTic Gaming",1931,"Version1 (Inactive)",1,5,13,5,7,1,1,0,5,7,0,6,1,1,0,6,0,7,5,"standard","2022-03-07T00:00:00.000Z","[2841,2483,398,2716,3211]","[3056,3352,440,3798,7025]","Breach,Sova,Astra,Chamber,Neon","Breach,Jett,Skye,Astra,Chamber",1588
57290,25946,"VCT North America 2022 - Stage 1 Challengers - Group Stage","Ascent",6426,"OpTic Gaming",1931,"Version1 (Inactive)",2,13,2,10,2,2,1,1,3,0,10,2,0,0,0,2,10,0,3,"standard","2022-03-07T00:00:00.000Z","[2483,2841,2716,398,3211]","[3056,7025,3352,3798,440]","Sova,Killjoy,Jett,Astra,KAY/O","Sova,Killjoy,Jett,Astra,KAY/O",1588
57334,25961,"VCT Brazil 2022 - Stage 1 Challengers 1 - Group Stage","Ascent",5747,"TBK Esports",53,"Team Vikings",2,13,3,10,2,2,1,1,3,1,10,2,0,0,0,2,10,1,3,"standard","2022-03-06T00:00:00.000Z","[2457,1506,5580,9831,2366]","[181,13153,2894,2607,1159]","Killjoy,Jett,Skye,Astra,KAY/O","Sova,Killjoy,Jett,Astra,KAY/O",1588
57289,25945,"VCT North America 2022 - Stage 1 Challengers - Group Stage","Split",305,"100 Thieves",603,"XSET",1,4,13,2,10,1,1,0,2,10,2,3,1,1,0,3,2,10,2,"standard","2022-03-06T00:00:00.000Z","[1012,763,355,1175,10253]","[3582,3062,3346,494,1802]","Breach,Raze,Viper,Astra,Chamber","Raze,Viper,Skye,Astra,Chamber",1588
57333,25961,"VCT Brazil 2022 - Stage 1 Challengers 1 - Group Stage","Split",5747,"TBK Esports",53,"Team Vikings",1,13,7,9,3,1,1,0,9,3,4,4,1,1,0,4,4,3,9,"standard","2022-03-06T00:00:00.000Z","[2366,2457,5580,9831,1506]","[2894,13153,181,1159,2607]","Raze,Viper,Skye,Astra,Chamber","Raze,Killjoy,Sage,Skye,Astra",1588
57288,25945,"VCT North America 2022 - Stage 1 Challengers - Group Stage","Fracture",305,"100 Thieves",603,"XSET",1,13,9,5,7,2,1,1,5,7,8,2,0,0,0,2,8,7,5,"standard","2022-03-06T00:00:00.000Z","[1012,763,355,1175,10253]","[3346,3582,3062,494,1802]","Breach,Raze,Viper,Astra,Chamber","Breach,Raze,Viper,Astra,Chamber",1588
57338,25963,"VCT Brazil 2022 - Stage 1 Challengers 1 - Group Stage","Icebox",319,"Liberty",580,"Gamelanders Blue",2,11,13,3,9,0,0,0,8,4,3,9,2,1,1,9,3,4,8,"standard","2022-03-06T00:00:00.000Z","[4745,2927,986,937,2054]","[622,739,1427,6038,4747]","Raze,Sova,Viper,Sage,Chamber","Sova,Viper,Sage,Jett,KAY/O",1588
57287,25945,"VCT North America 2022 - Stage 1 Challengers - Group Stage","Breeze",305,"100 Thieves",603,"XSET",2,8,13,5,7,0,0,0,3,6,5,7,2,1,1,7,5,6,3,"standard","2022-03-06T00:00:00.000Z","[10253,355,763,1012,1175]","[3346,3062,1802,494,3582]","Sova,Viper,Jett,KAY/O,Chamber","Sova,Viper,Jett,Astra,KAY/O",1588
57285,25944,"VCT LATAM South 2022 - Stage 1 Challengers 1 - Group Stage","Bind",976,"KRÜ Esports",738,"Leviatán",2,14,12,6,6,0,0,0,7,6,7,6,2,1,1,6,7,6,7,"standard","2022-03-06T00:00:00.000Z","[1725,4712,2532,4710,3535]","[6414,3531,3555,3532,3421]","Raze,Viper,Sage,Skye,Astra","Raze,Sova,Viper,Skye,Astra",1588
57337,25963,"VCT Brazil 2022 - Stage 1 Challengers 1 - Group Stage","Split",319,"Liberty",580,"Gamelanders Blue",2,13,15,8,4,2,1,1,4,10,9,5,0,0,0,5,9,10,4,"standard","2022-03-06T00:00:00.000Z","[4745,986,2927,937,2054]","[4747,739,622,1427,6038]","Raze,Viper,Skye,Astra,Chamber","Raze,Viper,Skye,Astra,Chamber",1588
57284,25944,"VCT LATAM South 2022 - Stage 1 Challengers 1 - Group Stage","Split",976,"KRÜ Esports",738,"Leviatán",1,13,9,5,7,1,1,0,5,7,8,2,1,1,0,2,8,7,5,"standard","2022-03-06T00:00:00.000Z","[1725,4712,2532,4710,3535]","[6414,3555,3532,3531,3421]","Raze,Viper,Jett,Skye,Astra","Raze,Viper,Jett,Skye,Astra",1588
57350,25967,"VCT EMEA 2022 - Stage 1 Challengers - Group Stage","Split",2654,"LDN UTD",224,"Team Liquid",2,10,13,7,5,1,1,0,3,8,7,5,1,1,0,5,7,8,3,"standard","2022-03-06T00:00:00.000Z","[2561,1894,2571,426,2305]","[10211,2056,17788,1690,1403]","Raze,Cypher,Sage,Astra,KAY/O","Breach,Raze,Cypher,Sage,Astra",1588
57349,25967,"VCT EMEA 2022 - Stage 1 Challengers - Group Stage","Haven",2654,"LDN UTD",224,"Team Liquid",1,8,13,5,7,1,0,1,5,7,3,6,1,0,1,6,3,7,5,"standard","2022-03-06T00:00:00.000Z","[426,2561,2571,1894,2305]","[1690,1403,17788,10211,2056]","Breach,Sova,Killjoy,Jett,Astra","Skye,Astra,KAY/O,Chamber,Neon",1588
57267,25938,"VCT Korea 2022 - Stage 1 Challengers : Group Stage","Bind",6366,"Maru Gaming",6360,"Desperado",2,13,5,7,5,2,1,1,6,0,7,5,0,0,0,5,7,0,6,"standard","2022-03-06T00:00:00.000Z","[6719,8382,18837,6740,4229]","[6690,19177,18866,227,3523]","Viper,Jett,Skye,Astra,Chamber","Sova,Jett,Astra,KAY/O,Neon",1588
57266,25938,"VCT Korea 2022 - Stage 1 Challengers : Group Stage","Ascent",6366,"Maru Gaming",6360,"Desperado",1,13,7,8,4,1,1,0,8,4,5,3,1,1,0,3,5,4,8,"standard","2022-03-06T00:00:00.000Z","[6719,8382,6740,18837,4229]","[3523,6690,19177,18866,227]","Sova,Jett,Astra,KAY/O,Chamber","Sova,Killjoy,Jett,Astra,KAY/O",1588
57264,25937,"VCT Korea 2022 - Stage 1 Challengers : Group Stage","Bind",5373,"On Sla2ers",286,"DRX",1,13,8,6,6,2,1,1,6,6,7,2,0,0,0,2,7,6,6,"standard","2022-03-06T00:00:00.000Z","[1199,2151,1075,2904,2009]","[1550,452,582,814,1251]","Sova,Viper,Jett,Skye,Astra","Raze,Viper,Skye,Astra,Chamber",1588
57263,25937,"VCT Korea 2022 - Stage 1 Challengers : Group Stage","Icebox",5373,"On Sla2ers",286,"DRX",1,13,3,9,3,2,1,1,9,3,4,0,0,0,0,0,4,3,9,"standard","2022-03-06T00:00:00.000Z","[1199,2151,2009,2904,1075]","[814,452,582,1550,1251]","Sova,Killjoy,Viper,Sage,Jett","Sova,Viper,Sage,Jett,Chamber",1588
57197,25915,"VCT North America 2022 - Stage 1 Challengers - Group Stage","Haven",116,"NRG Esports",588,"Knights",2,5,13,5,7,1,0,1,0,6,5,7,1,0,1,7,5,6,0,"standard","2022-03-06T00:00:00.000Z","[1597,493,165,1232,1763]","[2810,3894,3340,835,3831]","Sova,Killjoy,Jett,Astra,KAY/O","Sova,Killjoy,Jett,Skye,Astra",1588
57282,25943,"VCT Brazil 2022 - Stage 1 Challengers 1 - Group Stage","Icebox",1264,"FURIA",2564,"Sharks Esports",1,9,13,8,4,1,0,1,8,4,1,9,1,0,1,9,1,4,8,"standard","2022-03-06T00:00:00.000Z","[2752,6039,18192,2423,2749]","[1049,1877,4688,1971,2833]","Sova,Viper,Sage,Jett,Chamber","Sova,Killjoy,Viper,Sage,Jett",1588
57196,25915,"VCT North America 2022 - Stage 1 Challengers - Group Stage","Bind",116,"NRG Esports",588,"Knights",2,13,8,7,5,1,0,1,6,3,7,5,1,0,1,5,7,3,6,"standard","2022-03-06T00:00:00.000Z","[1763,493,1232,165,1597]","[835,2810,3831,3340,3894]","Raze,Viper,Brimstone,Sage,Skye","Raze,Sova,Viper,Jett,Astra",1588
57281,25943,"VCT Brazil 2022 - Stage 1 Challengers 1 - Group Stage","Breeze",1264,"FURIA",2564,"Sharks Esports",1,10,13,7,5,1,0,1,7,5,3,8,1,0,1,8,3,5,7,"standard","2022-03-05T00:00:00.000Z","[2749,2752,18192,2423,6039]","[1049,4688,2833,1971,1877]","Cypher,Sova,Viper,Jett,Skye","Sova,Viper,Jett,Skye,Chamber",1588
57195,25915,"VCT North America 2022 - Stage 1 Challengers - Group Stage","Breeze",116,"NRG Esports",588,"Knights",1,6,13,6,6,0,0,0,6,6,0,7,2,1,1,7,0,6,6,"standard","2022-03-05T00:00:00.000Z","[1597,1232,165,1763,493]","[3894,2810,3831,3340,835]","Sova,Viper,Jett,KAY/O,Chamber","Cypher,Sova,Viper,Jett,KAY/O",1588
57280,25942,"VCT Brazil 2022 - Stage 1 Challengers 1 - Group Stage","Ascent",72,"INGAMING Esports",600,"Keyd Stars",1,9,13,8,4,0,0,0,8,4,1,9,2,1,1,9,1,4,8,"standard","2022-03-05T00:00:00.000Z","[177,242,462,4771,9801]","[81,1661,277,5288,2901]","Cypher,Sova,Jett,Astra,KAY/O","Sova,Killjoy,Sage,Jett,Astra",1588
56651,25679,"VCT LATAM South 2022 - Stage 1 Challengers 1 - Group Stage","Haven",738,"Leviatán",1503,"Movistar Optix",1,13,11,10,2,1,1,0,10,2,3,9,1,1,0,9,3,2,10,"standard","2022-03-05T00:00:00.000Z","[6414,3555,3531,3532,3421]","[4619,3409,14762,3411,14764]","Breach,Cypher,Sova,Jett,Astra","Cypher,Sova,Reyna,Astra,Neon",1588
57193,25914,"VCT North America 2022 - Stage 1 Challengers - Group Stage","Bind",279,"Luminosity Gaming",141,"Cloud9",1,13,15,5,7,2,1,1,5,9,8,6,0,0,0,6,8,9,5,"standard","2022-03-05T00:00:00.000Z","[1801,2489,3345,1522,905]","[13591,1961,3599,4639,2213]","Raze,Sova,Viper,Astra,Chamber","Raze,Sova,Viper,Astra,Chamber",1588
57279,25942,"VCT Brazil 2022 - Stage 1 Challengers 1 - Group Stage","Breeze",72,"INGAMING Esports",600,"Keyd Stars",2,11,13,3,9,1,1,0,8,4,3,9,1,1,0,9,3,4,8,"standard","2022-03-05T00:00:00.000Z","[177,242,4771,462,9801]","[1661,81,2901,5288,277]","Cypher,Sova,Viper,Jett,Skye","Cypher,Sova,Viper,Jett,Neon",1588
56650,25679,"VCT LATAM South 2022 - Stage 1 Challengers 1 - Group Stage","Bind",738,"Leviatán",1503,"Movistar Optix",2,13,3,10,2,2,1,1,3,1,10,2,0,0,0,2,10,1,3,"standard","2022-03-05T00:00:00.000Z","[6414,3531,3555,3532,3421]","[14764,3409,14762,4619,3411]","Raze,Sova,Viper,Skye,Astra","Raze,Viper,Skye,Astra,Chamber",1588
57192,25914,"VCT North America 2022 - Stage 1 Challengers - Group Stage","Haven",279,"Luminosity Gaming",141,"Cloud9",2,3,13,1,11,1,1,0,2,2,1,11,1,1,0,11,1,2,2,"standard","2022-03-05T00:00:00.000Z","[2489,3345,905,1801,1522]","[1961,2213,3599,13591,4639]","Sova,Killjoy,Jett,Skye,Astra","Breach,Killjoy,Jett,Skye,Astra",1588
57278,25942,"VCT Brazil 2022 - Stage 1 Challengers 1 - Group Stage","Icebox",72,"INGAMING Esports",600,"Keyd Stars",1,13,9,8,4,0,0,0,8,4,5,5,2,1,1,5,5,4,8,"standard","2022-03-05T00:00:00.000Z","[242,177,4771,9801,462]","[81,277,2901,1661,5288]","Sova,Killjoy,Viper,Sage,Jett","Sova,Killjoy,Viper,Sage,Jett",1588
56648,25678,"VCT LATAM South 2022 - Stage 1 Challengers 1 - Group Stage","Haven",1052,"Meta Gaming",683,"9z Team",2,14,12,6,6,1,1,0,7,6,7,6,1,1,0,6,7,6,7,"standard","2022-03-05T00:00:00.000Z","[4629,1579,18848,2781,4618]","[1376,855,9905,849,3510]","Cypher,Sova,Jett,Astra,KAY/O","Breach,Sova,Killjoy,Omen,Jett",1588
57156,25898,"VCT EMEA 2022 - Stage 1 Challengers - Group Stage","Split",194,"G2 Esports (Inactive)",2597,"Acend",1,5,13,4,8,0,0,0,4,8,1,5,2,1,1,5,1,8,4,"standard","2022-03-05T00:00:00.000Z","[1826,2377,2594,2769,2940]","[2391,3208,691,1334,732]","Raze,Cypher,Sage,Omen,Jett","Raze,Cypher,Sage,Omen,Jett",1588
56647,25678,"VCT LATAM South 2022 - Stage 1 Challengers 1 - Group Stage","Ascent",1052,"Meta Gaming",683,"9z Team",1,14,12,3,9,1,1,0,4,9,10,3,1,1,0,3,10,9,4,"standard","2022-03-05T00:00:00.000Z","[1579,4629,18848,2781,4618]","[1376,9905,855,849,3510]","Sova,Killjoy,Jett,Astra,KAY/O","Sova,Killjoy,Reyna,Omen,Jett",1588
57155,25898,"VCT EMEA 2022 - Stage 1 Challengers - Group Stage","Ascent",194,"G2 Esports (Inactive)",2597,"Acend",1,9,13,7,5,1,1,0,7,5,2,8,1,1,0,8,2,5,7,"standard","2022-03-05T00:00:00.000Z","[1826,2377,2940,2769,2594]","[1334,3208,732,691,2391]","Sova,Killjoy,Jett,Astra,KAY/O","Sova,Killjoy,Jett,Astra,KAY/O",1588
57154,25898,"VCT EMEA 2022 - Stage 1 Challengers - Group Stage","Bind",194,"G2 Esports (Inactive)",2597,"Acend",2,13,7,8,4,0,0,0,5,3,8,4,2,1,1,4,8,3,5,"standard","2022-03-05T00:00:00.000Z","[1826,2377,2594,2769,2940]","[2391,3208,1334,732,691]","Raze,Viper,Skye,Astra,Chamber","Raze,Viper,Brimstone,Sage,Skye",1588
56953,25821,"VCT EMEA 2022 - Stage 1 Challengers - Group Stage","Icebox",520,"BBL Esports",3540,"SuperMassive",2,13,10,5,7,1,1,0,8,3,5,7,1,1,0,7,5,3,8,"standard","2022-03-05T00:00:00.000Z","[2864,3152,1749,1852,9643]","[9642,2969,3233,3725,9640]","Sova,Viper,Sage,Reyna,Jett","Sova,Killjoy,Viper,Sage,Jett",1588
56952,25821,"VCT EMEA 2022 - Stage 1 Challengers - Group Stage","Split",520,"BBL Esports",3540,"SuperMassive",1,13,7,9,3,2,1,1,9,3,4,4,0,0,0,4,4,3,9,"standard","2022-03-05T00:00:00.000Z","[3152,9643,1749,2864,1852]","[2969,3725,9640,9642,3233]","Breach,Raze,Cypher,Sage,Astra","Viper,Sage,Jett,Skye,Astra",1588
57262,25936,"VCT Korea 2022 - Stage 1 Challengers : Group Stage","Breeze",1515,"World Game Star",6510,"HolyMolly",2,11,13,4,8,0,0,0,7,5,4,8,2,1,1,8,4,5,7,"standard","2022-03-05T00:00:00.000Z","[293,3522,2650,2687,23167]","[3186,2908,15725,2508,1810]","Sova,Viper,Jett,Skye,Chamber","Sova,Viper,Jett,KAY/O,Chamber",1588
57261,25936,"VCT Korea 2022 - Stage 1 Challengers : Group Stage","Bind",1515,"World Game Star",6510,"HolyMolly",2,13,5,9,3,0,0,0,4,2,9,3,2,1,1,3,9,2,4,"standard","2022-03-05T00:00:00.000Z","[293,23167,2687,3522,2650]","[3186,1810,2508,15725,2908]","Sage,Reyna,Skye,Astra,Neon","Breach,Sova,Reyna,Jett,Astra",1588
57260,25936,"VCT Korea 2022 - Stage 1 Challengers : Group Stage","Haven",1515,"World Game Star",6510,"HolyMolly",1,7,13,4,8,1,0,1,4,8,3,5,1,0,1,5,3,8,4,"standard","2022-03-05T00:00:00.000Z","[2687,293,23167,2650,3522]","[2508,3186,1810,2908,15725]","Breach,Sova,Killjoy,Jett,Astra","Breach,Sova,Killjoy,Jett,Astra",1588
57241,25930,"VCT Korea 2022 - Stage 1 Challengers : Group Stage","Haven",6368,"Team T5",997,"DAMWON Gaming",2,8,13,8,4,1,0,1,0,9,8,4,1,0,1,4,8,9,0,"standard","2022-03-05T00:00:00.000Z","[6595,6546,1512,8058,6549]","[1406,2368,4811,2762,2240]","Sova,Jett,Astra,KAY/O,Chamber","Breach,Sova,Jett,Astra,Chamber",1588
57240,25930,"VCT Korea 2022 - Stage 1 Challengers : Group Stage","Bind",6368,"Team T5",997,"DAMWON Gaming",2,2,13,2,10,0,0,0,0,3,2,10,2,1,1,10,2,3,0,"standard","2022-03-05T00:00:00.000Z","[6595,6549,6546,8058,1512]","[4811,1406,2240,2368,2762]","Raze,Viper,Jett,Skye,Astra","Raze,Viper,Sage,Skye,Astra",1588
56542,25624,"VCT North America 2022 - Stage 1 Challengers - Group Stage","Icebox",1448,"Evil Geniuses",5201,"The Guard",1,11,13,5,7,1,0,1,5,7,6,6,1,0,1,6,6,7,5,"standard","2022-03-05T00:00:00.000Z","[722,11672,102,1023,4157]","[11412,4141,1804,1091,2551]","Sova,Viper,Sage,Jett,Chamber","Sova,Killjoy,Viper,Sage,Jett",1588
56541,25624,"VCT North America 2022 - Stage 1 Challengers - Group Stage","Haven",1448,"Evil Geniuses",5201,"The Guard",2,9,13,5,7,0,0,0,4,6,5,7,2,1,1,7,5,6,4,"standard","2022-03-05T00:00:00.000Z","[722,11672,1023,4157,102]","[11412,4141,2551,1091,1804]","Sova,Killjoy,Jett,Skye,Astra","Sova,Killjoy,Jett,Skye,Astra",1588
56546,25625,"VCT North America 2022 - Stage 1 Challengers - Group Stage","Bind",281,"Rise",388,"Sentinels",2,8,13,5,7,2,1,1,3,6,5,7,0,0,0,7,5,6,3,"standard","2022-03-04T00:00:00.000Z","[2091,269,1994,2105,1990]","[1614,893,724,3033,1485]","Raze,Sova,Viper,Jett,Astra","Raze,Sova,Viper,Jett,Astra",1588
56545,25625,"VCT North America 2022 - Stage 1 Challengers - Group Stage","Fracture",281,"Rise",388,"Sentinels",2,11,13,3,9,0,0,0,8,4,3,9,2,1,1,9,3,4,8,"standard","2022-03-04T00:00:00.000Z","[269,2091,1994,1990,2105]","[893,1485,3033,1614,724]","Breach,Raze,Viper,Astra,Chamber","Breach,Viper,Jett,Astra,Chamber",1588
56544,25625,"VCT North America 2022 - Stage 1 Challengers - Group Stage","Haven",281,"Rise",388,"Sentinels",1,13,9,7,5,1,1,0,7,5,6,4,1,1,0,4,6,5,7,"standard","2022-03-04T00:00:00.000Z","[1990,269,2105,1994,2091]","[893,3033,1614,1485,724]","Cypher,Sova,Jett,Astra,KAY/O","Sova,Jett,Skye,Astra,Chamber",1588
56857,25786,"VCT Korea 2022 - Stage 1 Challengers : Group Stage","Bind",6360,"Desperado",5373,"On Sla2ers",2,9,13,4,8,1,1,0,5,5,4,8,1,1,0,8,4,5,5,"standard","2022-03-04T00:00:00.000Z","[227,19177,6690,18866,3523]","[1075,2151,2904,1199,2009]","Raze,Jett,Skye,Astra,Neon","Raze,Viper,Jett,Skye,Astra",1588
56856,25786,"VCT Korea 2022 - Stage 1 Challengers : Group Stage","Haven",6360,"Desperado",5373,"On Sla2ers",2,4,13,2,10,0,0,0,2,3,2,10,2,1,1,10,2,3,2,"standard","2022-03-04T00:00:00.000Z","[3523,6690,227,19177,18866]","[2904,1199,2151,1075,2009]","Raze,Killjoy,Reyna,Jett,Astra","Breach,Sova,Killjoy,Jett,Astra",1588
56854,25785,"VCT Korea 2022 - Stage 1 Challengers : Group Stage","Breeze",6366,"Maru Gaming",286,"DRX",2,5,13,3,9,1,1,0,2,4,3,9,1,1,0,9,3,4,2,"standard","2022-03-04T00:00:00.000Z","[6719,6740,8382,18837,4229]","[814,452,1550,582,1251]","Sova,Viper,Jett,Skye,Chamber","Sova,Viper,Jett,Skye,Chamber",1588
56853,25785,"VCT Korea 2022 - Stage 1 Challengers : Group Stage","Split",6366,"Maru Gaming",286,"DRX",1,4,13,2,10,1,1,0,2,10,2,3,1,1,0,3,2,10,2,"standard","2022-03-04T00:00:00.000Z","[6719,8382,18837,6740,4229]","[1550,452,814,1251,582]","Viper,Jett,Skye,Astra,Chamber","Raze,Viper,Sage,Astra,KAY/O",1588
56852,25784,"VCT Korea 2022 - Stage 1 Challengers : Group Stage","Ascent",1515,"World Game Star",997,"DAMWON Gaming",2,5,13,5,7,0,0,0,0,6,5,7,2,1,1,7,5,6,0,"standard","2022-03-03T00:00:00.000Z","[2687,293,23167,2650,3522]","[2368,1406,4811,2762,2240]","Breach,Sova,Killjoy,Jett,Astra","Sova,Killjoy,Jett,Astra,KAY/O",1588
56851,25784,"VCT Korea 2022 - Stage 1 Challengers : Group Stage","Split",1515,"World Game Star",997,"DAMWON Gaming",2,6,13,6,6,1,0,1,0,7,6,6,1,0,1,6,6,7,0,"standard","2022-03-03T00:00:00.000Z","[2687,23167,293,2650,3522]","[1406,2368,4811,2762,2240]","Breach,Killjoy,Sage,Jett,Astra","Viper,Sage,Jett,Astra,Chamber",1588
56850,25784,"VCT Korea 2022 - Stage 1 Challengers : Group Stage","Haven",1515,"World Game Star",997,"DAMWON Gaming",1,13,10,7,5,2,1,1,7,5,6,5,0,0,0,5,6,5,7,"standard","2022-03-03T00:00:00.000Z","[2687,293,23167,2650,3522]","[2240,2368,1406,4811,2762]","Breach,Sova,Killjoy,Jett,Astra","Breach,Sova,Killjoy,Jett,Astra",1588
56848,25783,"VCT Korea 2022 - Stage 1 Challengers : Group Stage","Breeze",6368,"Team T5",6510,"HolyMolly",2,14,12,4,8,0,0,0,9,4,5,8,2,1,1,8,5,4,9,"standard","2022-03-03T00:00:00.000Z","[6595,8058,6546,1512,6549]","[3186,2908,15725,2508,1810]","Sova,Viper,Reyna,Omen,Chamber","Sova,Viper,Jett,KAY/O,Chamber",1588
56847,25783,"VCT Korea 2022 - Stage 1 Challengers : Group Stage","Ascent",6368,"Team T5",6510,"HolyMolly",1,13,6,9,3,1,1,0,9,3,4,3,1,1,0,3,4,3,9,"standard","2022-03-03T00:00:00.000Z","[6595,6549,6546,1512,8058]","[3186,1810,2508,15725,2908]","Sova,Killjoy,Reyna,Astra,KAY/O","Sova,Killjoy,Jett,Astra,KAY/O",1588
56845,25782,"VCT Korea 2022 - Stage 1 Challengers : Group Stage","Haven",997,"DAMWON Gaming",5373,"On Sla2ers",1,5,13,5,7,1,1,0,5,7,0,6,1,1,0,6,0,7,5,"standard","2022-03-02T00:00:00.000Z","[2368,1406,4811,2240,2762]","[2904,1199,2151,1075,2009]","Sova,Killjoy,Jett,Skye,Astra","Breach,Sova,Killjoy,Jett,Astra",1588
56844,25782,"VCT Korea 2022 - Stage 1 Challengers : Group Stage","Ascent",997,"DAMWON Gaming",5373,"On Sla2ers",1,4,13,3,9,0,0,0,3,9,1,4,2,1,1,4,1,9,3,"standard","2022-03-02T00:00:00.000Z","[2368,1406,4811,2762,2240]","[1199,2151,1075,2009,2904]","Sova,Killjoy,Jett,Astra,KAY/O","Sova,Killjoy,Jett,Astra,KAY/O",1588
56843,25781,"VCT Korea 2022 - Stage 1 Challengers : Group Stage","Ascent",6366,"Maru Gaming",6510,"HolyMolly",1,13,4,9,3,0,0,0,9,3,4,1,2,1,1,1,4,3,9,"standard","2022-03-02T00:00:00.000Z","[6719,8382,6740,18837,4229]","[3186,1810,2508,15725,2908]","Sova,Jett,Astra,KAY/O,Chamber","Sova,Killjoy,Jett,Astra,KAY/O",1588
56842,25781,"VCT Korea 2022 - Stage 1 Challengers : Group Stage","Split",6366,"Maru Gaming",6510,"HolyMolly",1,3,13,3,9,0,0,0,3,9,0,4,2,1,1,4,0,9,3,"standard","2022-03-02T00:00:00.000Z","[6719,8382,18837,6740,4229]","[2908,1810,3186,15725,2508]","Viper,Jett,Skye,Astra,Chamber","Raze,Viper,Sage,Astra,KAY/O",1588
56841,25781,"VCT Korea 2022 - Stage 1 Challengers : Group Stage","Fracture",6366,"Maru Gaming",6510,"HolyMolly",2,13,6,6,6,2,1,1,7,0,6,6,0,0,0,6,6,0,7,"standard","2022-03-02T00:00:00.000Z","[18837,8382,6740,6719,4229]","[3186,1810,2908,2508,15725]","Breach,Jett,Astra,KAY/O,Chamber","Breach,Cypher,Brimstone,Sage,Neon",1588
56426,25569,"VCT North America 2022 - Stage 1 Challengers - Group Stage","Icebox",1931,"Version1 (Inactive)",116,"NRG Esports",1,13,11,6,6,0,0,0,6,6,7,5,2,1,1,5,7,6,6,"standard","2022-02-28T00:00:00.000Z","[3056,3798,7025,3352,440]","[1597,493,1232,1763,165]","Sova,Viper,Sage,Jett,KAY/O","Sova,Viper,Sage,KAY/O,Chamber",1588
56425,25569,"VCT North America 2022 - Stage 1 Challengers - Group Stage","Fracture",1931,"Version1 (Inactive)",116,"NRG Esports",1,13,11,9,3,1,1,0,9,3,4,8,1,1,0,8,4,3,9,"standard","2022-02-28T00:00:00.000Z","[3056,440,7025,3798,3352]","[1597,1763,493,1232,165]","Breach,Raze,Viper,Astra,Chamber","Breach,Raze,Viper,Astra,Chamber",1588
56424,25569,"VCT North America 2022 - Stage 1 Challengers - Group Stage","Haven",1931,"Version1 (Inactive)",116,"NRG Esports",1,12,14,6,6,0,0,0,6,7,6,7,2,1,1,7,6,7,6,"standard","2022-02-28T00:00:00.000Z","[440,3056,3352,3798,7025]","[1597,493,165,1232,1763]","Breach,Sova,Jett,Astra,Chamber","Sova,Killjoy,Jett,Astra,KAY/O",1588
55740,25275,"VCT Brazil 2022 - Stage 1 Challengers 1 - Group Stage","Split",600,"Keyd Stars",5750,"Ninjas in Pyjamas",1,10,13,2,10,1,0,1,2,10,8,3,1,0,1,3,8,10,2,"standard","2022-02-28T00:00:00.000Z","[81,1661,5288,2901,277]","[3203,762,16804,3408,2195]","Raze,Viper,Jett,Astra,Chamber","Raze,Cypher,Sage,Omen,Jett",1588
55739,25275,"VCT Brazil 2022 - Stage 1 Challengers 1 - Group Stage","Bind",600,"Keyd Stars",5750,"Ninjas in Pyjamas",2,13,8,8,4,0,0,0,5,4,8,4,2,1,1,4,8,4,5,"standard","2022-02-27T00:00:00.000Z","[81,1661,277,2901,5288]","[16804,3408,2195,3203,762]","Raze,Viper,Skye,Astra,Chamber","Sova,Viper,Jett,Skye,Astra",1588
56423,25568,"VCT North America 2022 - Stage 1 Challengers - Group Stage","Breeze",279,"Luminosity Gaming",305,"100 Thieves",1,14,12,6,6,0,0,0,7,6,7,6,2,1,1,6,7,6,7,"standard","2022-02-27T00:00:00.000Z","[3345,2489,1522,905,1801]","[10253,355,763,1012,1175]","Cypher,Sova,Viper,Jett,KAY/O","Sova,Viper,Jett,KAY/O,Chamber",1588
55738,25275,"VCT Brazil 2022 - Stage 1 Challengers 1 - Group Stage","Icebox",600,"Keyd Stars",5750,"Ninjas in Pyjamas",1,9,13,8,4,1,1,0,8,4,1,9,1,1,0,9,1,4,8,"standard","2022-02-27T00:00:00.000Z","[81,2901,1661,277,5288]","[16804,3408,762,2195,3203]","Sova,Viper,Sage,Reyna,Jett","Sova,Viper,Sage,Reyna,Jett",1588
56422,25568,"VCT North America 2022 - Stage 1 Challengers - Group Stage","Fracture",279,"Luminosity Gaming",305,"100 Thieves",1,9,13,5,7,1,0,1,5,7,4,6,1,0,1,6,4,7,5,"standard","2022-02-27T00:00:00.000Z","[2489,1801,3345,1522,905]","[1012,763,355,1175,10253]","Breach,Raze,Viper,Astra,Chamber","Breach,Raze,Viper,Astra,Chamber",1588
56645,25677,"VCT LATAM South 2022 - Stage 1 Challengers 1 - Group Stage","Haven",976,"KRÜ Esports",683,"9z Team",2,13,11,7,5,2,1,1,6,6,7,5,0,0,0,5,7,6,6,"standard","2022-02-27T00:00:00.000Z","[4712,4710,1725,2532,3535]","[3510,1376,855,3506,9905]","Cypher,Sova,Phoenix,Jett,Astra","Breach,Sova,Killjoy,Jett,Astra",1588
55736,25274,"VCT Brazil 2022 - Stage 1 Challengers 1 - Group Stage","Breeze",72,"INGAMING Esports",2564,"Sharks Esports",2,13,9,8,4,0,0,0,5,5,8,4,2,1,1,4,8,5,5,"standard","2022-02-27T00:00:00.000Z","[177,242,4771,462,9801]","[1877,1049,4688,2833,1971]","Cypher,Sova,Viper,Jett,Skye","Cypher,Sova,Viper,Jett,KAY/O",1588
56644,25677,"VCT LATAM South 2022 - Stage 1 Challengers 1 - Group Stage","Split",976,"KRÜ Esports",683,"9z Team",1,13,6,9,3,0,0,0,9,3,4,3,2,1,1,3,4,3,9,"standard","2022-02-27T00:00:00.000Z","[1725,4712,2532,4710,3535]","[855,1376,3510,9905,3506]","Raze,Viper,Jett,Skye,Astra","Raze,Viper,Skye,Astra,Chamber",1588
56421,25568,"VCT North America 2022 - Stage 1 Challengers - Group Stage","Split",279,"Luminosity Gaming",305,"100 Thieves",2,13,9,8,4,2,1,1,5,5,8,4,0,0,0,4,8,5,5,"standard","2022-02-27T00:00:00.000Z","[1801,3345,905,2489,1522]","[763,355,1012,1175,10253]","Raze,Cypher,Sage,Skye,Astra","Raze,Viper,Skye,Astra,Chamber",1588
56642,25676,"VCT LATAM South 2022 - Stage 1 Challengers 1 - Group Stage","Fracture",1503,"Movistar Optix",5305,"EBRO Gaming",2,13,8,6,6,2,1,1,7,2,6,6,0,0,0,6,6,2,7,"standard","2022-02-27T00:00:00.000Z","[14762,14764,4619,3409,3411]","[3507,4605,5831,4061,4791]","Breach,Raze,Cypher,Viper,Astra","Breach,Raze,Viper,Skye,Astra",1588
55735,25274,"VCT Brazil 2022 - Stage 1 Challengers 1 - Group Stage","Haven",72,"INGAMING Esports",2564,"Sharks Esports",1,13,10,7,5,0,0,0,7,5,6,5,2,1,1,5,6,5,7,"standard","2022-02-27T00:00:00.000Z","[9801,242,177,462,4771]","[1049,1877,2833,4688,1971]","Breach,Sova,Killjoy,Jett,Astra","Sova,Killjoy,Jett,Astra,KAY/O",1588
56641,25676,"VCT LATAM South 2022 - Stage 1 Challengers 1 - Group Stage","Ascent",1503,"Movistar Optix",5305,"EBRO Gaming",2,13,8,9,3,1,0,1,4,5,9,3,1,0,1,3,9,5,4,"standard","2022-02-27T00:00:00.000Z","[3409,4619,14764,3411,14762]","[3507,5831,4605,4061,4791]","Sova,Killjoy,Jett,Astra,KAY/O","Sova,Killjoy,Jett,Skye,Astra",1588
56581,25645,"VCT Japan 2022 - Stage 1 Challengers 1 : Week 1 - Main Event","Haven",611,"ZETA DIVISION",444,"Crazy Raccoon",2,13,11,5,7,2,1,1,8,4,5,7,0,0,0,7,5,4,8,"standard","2022-02-27T00:00:00.000Z","[2699,2212,1593,519,2232]","[1231,2388,876,1886,8025]","Breach,Killjoy,Jett,Skye,Astra","Sova,Killjoy,Jett,Skye,Astra",1588
56580,25645,"VCT Japan 2022 - Stage 1 Challengers 1 : Week 1 - Main Event","Icebox",611,"ZETA DIVISION",444,"Crazy Raccoon",1,13,2,10,2,2,1,1,10,2,3,0,0,0,0,0,3,2,10,"standard","2022-02-27T00:00:00.000Z","[2699,2232,519,1593,2212]","[1231,8025,2388,876,1886]","Sova,Viper,Sage,Jett,Chamber","Sova,Viper,Sage,Reyna,Jett",1588
56575,25641,"VCT Korea 2022 - Stage 1 Challengers : Group Stage","Ascent",286,"DRX",6368,"Team T5",2,13,4,9,3,1,1,0,4,1,9,3,1,1,0,3,9,1,4,"standard","2022-02-27T00:00:00.000Z","[814,1550,582,452,1251]","[6595,6549,6546,1512,8058]","Sova,Jett,Skye,Astra,Chamber","Sova,Killjoy,Reyna,Omen,KAY/O",1588
56574,25641,"VCT Korea 2022 - Stage 1 Challengers : Group Stage","Breeze",286,"DRX",6368,"Team T5",1,13,9,8,4,1,1,0,8,4,5,5,1,1,0,5,5,4,8,"standard","2022-02-27T00:00:00.000Z","[814,452,1550,582,1251]","[6595,8058,6546,1512,6549]","Sova,Viper,Jett,Skye,Chamber","Sova,Viper,Reyna,Omen,Chamber",1588
56534,25619,"VCT Japan 2022 - Stage 1 Challengers 1 : Week 1 - Main Event","Fracture",1840,"NORTHEPTION",611,"ZETA DIVISION",2,9,13,3,9,1,1,0,6,4,3,9,1,1,0,9,3,4,6,"standard","2022-02-27T00:00:00.000Z","[3060,12341,8882,3968,652]","[2699,519,1593,2232,2212]","Breach,Raze,Viper,Astra,Chamber","Breach,Raze,Jett,Astra,Chamber",1588
56533,25619,"VCT Japan 2022 - Stage 1 Challengers 1 : Week 1 - Main Event","Bind",1840,"NORTHEPTION",611,"ZETA DIVISION",2,13,8,8,4,1,0,1,5,4,8,4,1,0,1,4,8,4,5,"standard","2022-02-27T00:00:00.000Z","[3060,8882,12341,652,3968]","[519,2212,1593,2699,2232]","Breach,Viper,Jett,Skye,Astra","Raze,Viper,Sage,Skye,Astra",1588
56685,25709,"VCT Korea 2022 - Stage 1 Challengers : Group Stage","Bind",1515,"World Game Star",6360,"Desperado",2,14,12,7,5,1,0,1,6,7,8,5,1,0,1,5,8,7,6,"standard","2022-02-27T00:00:00.000Z","[23167,2687,293,2650,3522]","[19177,6690,18866,227,3523]","Breach,Raze,Sova,Jett,Astra","Jett,Skye,Astra,KAY/O,Neon",1588
56532,25619,"VCT Japan 2022 - Stage 1 Challengers 1 : Week 1 - Main Event","Haven",1840,"NORTHEPTION",611,"ZETA DIVISION",1,7,13,5,7,1,1,0,5,7,2,6,1,1,0,6,2,7,5,"standard","2022-02-27T00:00:00.000Z","[3060,3968,12341,652,8882]","[2699,2212,1593,519,2232]","Breach,Killjoy,Jett,Skye,Astra","Breach,Killjoy,Jett,Skye,Astra",1588
56684,25709,"VCT Korea 2022 - Stage 1 Challengers : Group Stage","Haven",1515,"World Game Star",6360,"Desperado",1,14,12,8,4,1,1,0,9,4,5,8,1,1,0,8,5,4,9,"standard","2022-02-27T00:00:00.000Z","[2687,293,23167,2650,3522]","[3523,6690,227,19177,18866]","Breach,Sova,Killjoy,Jett,Astra","Raze,Killjoy,Reyna,Jett,Astra",1588
56516,25614,"VCT Japan 2022 - Stage 1 Challengers 1 : Week 1 - Main Event","Icebox",444,"Crazy Raccoon",206,"Sengoku Gaming",1,13,10,7,5,1,0,1,7,5,6,5,1,0,1,5,6,5,7,"standard","2022-02-27T00:00:00.000Z","[1231,8025,2388,876,1886]","[15602,2291,9539,9540,6773]","Sova,Viper,Sage,Reyna,Jett","Sova,Killjoy,Viper,Sage,Jett",1588
56515,25614,"VCT Japan 2022 - Stage 1 Challengers 1 : Week 1 - Main Event","Haven",444,"Crazy Raccoon",206,"Sengoku Gaming",2,13,5,7,5,1,1,0,6,0,7,5,1,1,0,5,7,0,6,"standard","2022-02-27T00:00:00.000Z","[1231,2388,876,1886,8025]","[9540,2291,6773,15602,9539]","Sova,Killjoy,Jett,Skye,Astra","Breach,Killjoy,Jett,Skye,Astra",1588
55749,25278,"VCT North America 2022 - Stage 1 Challengers - Group Stage","Fracture",5201,"The Guard",603,"XSET",2,13,3,11,1,1,0,1,2,2,11,1,1,0,1,1,11,2,2,"standard","2022-02-27T00:00:00.000Z","[11412,2551,1091,1804,4141]","[3346,3582,3062,494,1802]","Breach,Raze,Viper,Astra,Chamber","Breach,Raze,Viper,Astra,Chamber",1588
55748,25278,"VCT North America 2022 - Stage 1 Challengers - Group Stage","Bind",5201,"The Guard",603,"XSET",2,11,13,7,5,0,0,0,4,8,7,5,2,1,1,5,7,8,4,"standard","2022-02-27T00:00:00.000Z","[2551,11412,4141,1804,1091]","[3582,3346,3062,1802,494]","Raze,Sova,Viper,Astra,KAY/O","Raze,Sova,Viper,Jett,Astra",1588
55747,25278,"VCT North America 2022 - Stage 1 Challengers - Group Stage","Haven",5201,"The Guard",603,"XSET",2,13,7,8,4,2,1,1,5,3,8,4,0,0,0,4,8,3,5,"standard","2022-02-27T00:00:00.000Z","[11412,4141,2551,1091,1804]","[3062,3346,1802,3582,494]","Sova,Killjoy,Jett,Skye,Astra","Cypher,Sova,Jett,Skye,Astra",1588
55733,25273,"VCT Brazil 2022 - Stage 1 Challengers 1 - Group Stage","Bind",5747,"TBK Esports",6344,"LOUD",2,0,13,0,12,0,0,0,0,1,0,12,2,1,1,12,0,1,0,"standard","2022-02-27T00:00:00.000Z","[2366,2457,5580,9831,1506]","[4748,2294,4746,2895,6037]","Raze,Viper,Skye,Astra,Chamber","Raze,Sova,Viper,Skye,Astra",1588
55732,25273,"VCT Brazil 2022 - Stage 1 Challengers 1 - Group Stage","Ascent",5747,"TBK Esports",6344,"LOUD",1,4,13,2,10,1,0,1,2,10,2,3,1,0,1,3,2,10,2,"standard","2022-02-26T00:00:00.000Z","[2457,1506,5580,9831,2366]","[2294,4746,4748,6037,2895]","Killjoy,Jett,Skye,Astra,KAY/O","Sova,Killjoy,Jett,Astra,KAY/O",1588
55752,25279,"VCT North America 2022 - Stage 1 Challengers - Group Stage","Icebox",388,"Sentinels",6426,"OpTic Gaming",2,9,13,5,7,0,0,0,4,6,5,7,2,1,1,7,5,6,4,"standard","2022-02-26T00:00:00.000Z","[893,1485,1614,3033,724]","[2483,398,2841,3211,2716]","Sova,Viper,Sage,Jett,Chamber","Sova,Viper,Sage,KAY/O,Chamber",1588
55731,25272,"VCT Brazil 2022 - Stage 1 Challengers 1 - Group Stage","Ascent",53,"Team Vikings",580,"Gamelanders Blue",1,4,13,4,8,0,0,0,4,8,0,5,2,1,1,5,0,8,4,"standard","2022-02-26T00:00:00.000Z","[181,13153,1159,2607,2894]","[622,739,6038,1427,4747]","Sova,Killjoy,Jett,Astra,KAY/O","Sova,Killjoy,Jett,Astra,KAY/O",1588
55727,25271,"VCT LATAM South 2022 - Stage 1 Challengers 1 - Group Stage","Haven",976,"KRÜ Esports",1052,"Meta Gaming",2,13,1,11,1,2,1,1,2,0,11,1,0,0,0,1,11,0,2,"standard","2022-02-26T00:00:00.000Z","[4712,4710,1725,2532,3535]","[4629,1579,18848,2781,4618]","Cypher,Sova,Phoenix,Jett,Astra","Cypher,Sova,Jett,Astra,KAY/O",1588
55751,25279,"VCT North America 2022 - Stage 1 Challengers - Group Stage","Fracture",388,"Sentinels",6426,"OpTic Gaming",2,13,10,8,4,2,1,1,5,6,8,4,0,0,0,4,8,6,5,"standard","2022-02-26T00:00:00.000Z","[893,1485,3033,1614,724]","[2841,3211,2483,398,2716]","Breach,Viper,Jett,Astra,Chamber","Breach,Raze,Viper,Astra,Chamber",1588
55730,25272,"VCT Brazil 2022 - Stage 1 Challengers 1 - Group Stage","Icebox",53,"Team Vikings",580,"Gamelanders Blue",2,13,8,4,8,1,1,0,9,0,4,8,1,1,0,8,4,0,9,"standard","2022-02-26T00:00:00.000Z","[181,2607,13153,1159,2894]","[622,739,1427,4747,6038]","Sova,Viper,Sage,Reyna,Chamber","Sova,Viper,Sage,Reyna,Jett",1588
55726,25271,"VCT LATAM South 2022 - Stage 1 Challengers 1 - Group Stage","Split",976,"KRÜ Esports",1052,"Meta Gaming",1,13,9,7,5,1,0,1,7,5,6,4,1,0,1,4,6,5,7,"standard","2022-02-26T00:00:00.000Z","[4710,4712,2532,3539,3535]","[4618,4629,18848,1579,2781]","Raze,Viper,Jett,Skye,Astra","Raze,Cypher,Jett,Skye,Astra",1588
55750,25279,"VCT North America 2022 - Stage 1 Challengers - Group Stage","Bind",388,"Sentinels",6426,"OpTic Gaming",1,2,13,2,10,0,0,0,2,10,0,3,2,1,1,3,0,10,2,"standard","2022-02-26T00:00:00.000Z","[1614,893,724,3033,1485]","[3211,2483,2841,398,2716]","Raze,Sova,Viper,Jett,Astra","Raze,Sova,Viper,Astra,Chamber",1588
55729,25272,"VCT Brazil 2022 - Stage 1 Challengers 1 - Group Stage","Haven",53,"Team Vikings",580,"Gamelanders Blue",1,7,13,4,8,2,1,1,4,8,3,5,0,0,0,5,3,8,4,"standard","2022-02-26T00:00:00.000Z","[181,13153,1159,2607,2894]","[739,622,6038,1427,4747]","Sova,Killjoy,Jett,Astra,KAY/O","Cypher,Sova,Jett,Astra,KAY/O",1588
55724,25270,"VCT LATAM South 2022 - Stage 1 Challengers 1 - Group Stage","Haven",738,"Leviatán",5305,"EBRO Gaming",2,13,5,8,4,2,1,1,5,1,8,4,0,0,0,4,8,1,5,"standard","2022-02-26T00:00:00.000Z","[6414,3555,3531,3532,3421]","[3507,5831,4605,4061,4791]","Breach,Cypher,Sova,Jett,Astra","Sova,Killjoy,Jett,Skye,Astra",1588
55723,25270,"VCT LATAM South 2022 - Stage 1 Challengers 1 - Group Stage","Breeze",738,"Leviatán",5305,"EBRO Gaming",2,13,7,8,4,0,0,0,5,3,8,4,2,1,1,4,8,3,5,"standard","2022-02-26T00:00:00.000Z","[3531,3421,3532,6414,3555]","[5831,3507,4791,4605,4061]","Sova,Viper,Jett,KAY/O,Chamber","Cypher,Sova,Viper,Jett,Skye",1588
56470,25587,"VCT Japan 2022 - Stage 1 Challengers 1 : Week 1 - Main Event","Icebox",5294,"IGZIST",334,"REJECT",1,4,13,3,9,0,0,0,3,9,1,4,2,1,1,4,1,9,3,"standard","2022-02-26T00:00:00.000Z","[3521,2049,1401,1603,2015]","[3011,2791,802,852,2584]","Sova,Viper,Sage,Jett,Chamber","Sova,Viper,Sage,Jett,Chamber",1588
56469,25587,"VCT Japan 2022 - Stage 1 Challengers 1 : Week 1 - Main Event","Bind",5294,"IGZIST",334,"REJECT",1,2,13,2,10,0,0,0,2,10,0,3,2,1,1,3,0,10,2,"standard","2022-02-26T00:00:00.000Z","[3521,2015,1603,2049,1401]","[852,3011,2791,802,2584]","Raze,Viper,Jett,Skye,Astra","Raze,Viper,Brimstone,Sage,Skye",1588
56468,25587,"VCT Japan 2022 - Stage 1 Challengers 1 : Week 1 - Main Event","Haven",5294,"IGZIST",334,"REJECT",2,13,6,10,2,0,0,0,3,4,10,2,2,1,1,2,10,4,3,"standard","2022-02-26T00:00:00.000Z","[2049,1603,3521,1401,2015]","[2584,3011,852,2791,802]","Breach,Jett,Skye,Astra,Chamber","Sova,Killjoy,Jett,Astra,KAY/O",1588
56440,25574,"VCT Korea 2022 - Stage 1 Challengers : Group Stage","Haven",6366,"Maru Gaming",997,"DAMWON Gaming",2,10,13,7,5,1,0,1,3,8,7,5,1,0,1,5,7,8,3,"standard","2022-02-26T00:00:00.000Z","[18837,6719,8382,6740,4229]","[2368,1406,4812,2240,2762]","Breach,Sova,Jett,Astra,Chamber","Sova,Killjoy,Jett,Skye,Astra",1588
56439,25574,"VCT Korea 2022 - Stage 1 Challengers : Group Stage","Fracture",6366,"Maru Gaming",997,"DAMWON Gaming",2,9,13,5,7,1,0,1,4,6,5,7,1,0,1,7,5,6,4,"standard","2022-02-26T00:00:00.000Z","[18837,8382,6740,6719,4229]","[2240,4812,2368,2762,1406]","Breach,Jett,Astra,KAY/O,Chamber","Breach,Raze,Sage,Astra,Chamber",1588
56447,25576,"VCT Japan 2022 - Stage 1 Challengers 1 : Week 1 - Main Event","Haven",740,"BLUE BEES.ESP",334,"REJECT",2,7,13,2,10,0,0,0,5,3,2,10,2,1,1,10,2,3,5,"standard","2022-02-26T00:00:00.000Z","[1212,2978,15518,3966,23136]","[2584,3011,852,2791,802]","Breach,Killjoy,Jett,Skye,Astra","Sova,Killjoy,Jett,Astra,KAY/O",1588
56446,25576,"VCT Japan 2022 - Stage 1 Challengers 1 : Week 1 - Main Event","Breeze",740,"BLUE BEES.ESP",334,"REJECT",2,11,13,6,6,0,0,0,5,7,6,6,2,1,1,6,6,7,5,"standard","2022-02-26T00:00:00.000Z","[2978,3966,23136,15518,1212]","[2584,2791,852,3011,802]","Cypher,Sova,Viper,Jett,Skye","Sova,Viper,Reyna,Astra,Chamber",1588
56432,25571,"VCT Korea 2022 - Stage 1 Challengers : Group Stage","Haven",5373,"On Sla2ers",6510,"HolyMolly",1,13,4,8,4,2,1,1,8,4,5,0,0,0,0,0,5,4,8,"standard","2022-02-26T00:00:00.000Z","[2904,1199,2151,1075,2009]","[3186,2508,15725,1810,2908]","Breach,Sova,Killjoy,Jett,Astra","Breach,Skye,Astra,Chamber,Neon",1588
56445,25576,"VCT Japan 2022 - Stage 1 Challengers 1 : Week 1 - Main Event","Split",740,"BLUE BEES.ESP",334,"REJECT",1,13,6,6,6,1,0,1,6,6,7,0,1,0,1,0,7,6,6,"standard","2022-02-26T00:00:00.000Z","[2978,1212,15518,3966,23136]","[2584,852,2791,3011,802]","Killjoy,Sage,Jett,Skye,Astra","Raze,Sage,Astra,KAY/O,Chamber",1588
56431,25571,"VCT Korea 2022 - Stage 1 Challengers : Group Stage","Bind",5373,"On Sla2ers",6510,"HolyMolly",1,13,2,12,0,1,1,0,12,0,1,2,1,1,0,2,1,0,12,"standard","2022-02-26T00:00:00.000Z","[1075,2151,2904,1199,2009]","[2908,1810,3186,2508,15725]","Raze,Viper,Sage,Skye,Astra","Raze,Viper,Sage,Skye,Astra",1588
56429,25570,"VCT Japan 2022 - Stage 1 Challengers 1 : Week 1 - Main Event","Fracture",5294,"IGZIST",2062,"FENNEL",1,13,4,8,4,2,1,1,8,4,5,0,0,0,0,0,5,4,8,"standard","2022-02-26T00:00:00.000Z","[2049,3521,2015,1401,1603]","[2272,2706,8948,391,10]","Breach,Raze,Viper,Astra,Chamber","Breach,Raze,Cypher,Sage,Astra",1588
56430,25571,"VCT Korea 2022 - Stage 1 Challengers : Group Stage","Split",5373,"On Sla2ers",6510,"HolyMolly",2,11,13,6,6,0,0,0,5,7,6,6,2,1,1,6,6,7,5,"standard","2022-02-26T00:00:00.000Z","[1075,2151,2904,1199,2009]","[2908,1810,3186,15725,2508]","Raze,Viper,Sage,Skye,Astra","Raze,Viper,Sage,Astra,KAY/O",1588
56428,25570,"VCT Japan 2022 - Stage 1 Challengers 1 : Week 1 - Main Event","Haven",5294,"IGZIST",2062,"FENNEL",1,10,13,8,4,1,1,0,8,4,2,9,1,1,0,9,2,4,8,"standard","2022-02-26T00:00:00.000Z","[2049,2015,1603,3521,1401]","[391,2272,8948,2706,10]","Breach,Killjoy,Jett,Skye,Astra","Breach,Sova,Killjoy,Jett,Astra",1588
56427,25570,"VCT Japan 2022 - Stage 1 Challengers 1 : Week 1 - Main Event","Breeze",5294,"IGZIST",2062,"FENNEL",1,13,6,6,6,2,1,1,6,6,7,0,0,0,0,0,7,6,6,"standard","2022-02-26T00:00:00.000Z","[3521,1401,1603,2049,2015]","[8948,2272,10,2706,391]","Sova,Viper,Jett,KAY/O,Chamber","Cypher,Sova,Viper,Jett,Skye",1588
55745,25277,"VCT North America 2022 - Stage 1 Challengers - Group Stage","Bind",588,"Knights",281,"Rise",2,13,8,8,4,1,0,1,5,4,8,4,1,0,1,4,8,4,5,"standard","2022-02-26T00:00:00.000Z","[835,2810,3831,3340,3894]","[2091,269,1994,1990,2105]","Raze,Sova,Viper,Jett,Astra","Raze,Sova,Viper,Astra,Chamber",1588
55744,25277,"VCT North America 2022 - Stage 1 Challengers - Group Stage","Ascent",588,"Knights",281,"Rise",1,13,9,4,8,1,0,1,4,8,9,1,1,0,1,1,9,8,4,"standard","2022-02-25T00:00:00.000Z","[2810,3894,835,3340,3831]","[269,1990,2105,1994,2091]","Sova,Killjoy,Sage,Jett,Astra","Sova,Killjoy,Jett,Astra,KAY/O",1588
55743,25276,"VCT North America 2022 - Stage 1 Challengers - Group Stage","Ascent",141,"Cloud9",1448,"Evil Geniuses",1,13,2,10,2,2,1,1,10,2,3,0,0,0,0,0,3,2,10,"standard","2022-02-25T00:00:00.000Z","[1961,2213,3599,4639,13591]","[722,11672,1023,102,4157]","Sova,Killjoy,Jett,Astra,KAY/O","Sova,Killjoy,Jett,Astra,KAY/O",1588
55742,25276,"VCT North America 2022 - Stage 1 Challengers - Group Stage","Breeze",141,"Cloud9",1448,"Evil Geniuses",1,8,13,5,7,0,0,0,5,7,3,6,2,1,1,6,3,7,5,"standard","2022-02-25T00:00:00.000Z","[1961,4639,3599,13591,2213]","[102,11672,1023,722,4157]","Sova,Viper,Jett,KAY/O,Chamber","Sova,Viper,Jett,KAY/O,Chamber",1588
55741,25276,"VCT North America 2022 - Stage 1 Challengers - Group Stage","Haven",141,"Cloud9",1448,"Evil Geniuses",1,13,5,9,3,1,1,0,9,3,4,2,1,1,0,2,4,3,9,"standard","2022-02-25T00:00:00.000Z","[1961,2213,3599,13591,4639]","[722,11672,1023,4157,102]","Breach,Killjoy,Jett,Skye,Astra","Sova,Killjoy,Jett,Skye,Astra",1588
55978,25390,"VCT Korea 2022 - Stage 1 Challengers : Group Stage","Ascent",6368,"Team T5",6360,"Desperado",1,12,14,5,7,2,1,1,5,8,7,6,0,0,0,6,7,8,5,"standard","2022-02-25T00:00:00.000Z","[6595,6549,6546,1512,8058]","[3523,6690,227,19177,18866]","Sova,Killjoy,Reyna,Omen,KAY/O","Raze,Sova,Reyna,Jett,Astra",1588
55977,25390,"VCT Korea 2022 - Stage 1 Challengers : Group Stage","Haven",6368,"Team T5",6360,"Desperado",2,10,13,8,4,1,0,1,2,9,8,4,1,0,1,4,8,9,2,"standard","2022-02-25T00:00:00.000Z","[6595,1512,6546,8058,6549]","[3523,6690,227,19177,18866]","Sova,Omen,Jett,KAY/O,Chamber","Raze,Cypher,Reyna,Jett,Astra",1588
55975,25389,"VCT Korea 2022 - Stage 1 Challengers : Group Stage","Ascent",1515,"World Game Star",286,"DRX",2,5,13,3,9,0,0,0,2,4,3,9,2,1,1,9,3,4,2,"standard","2022-02-25T00:00:00.000Z","[2687,293,23167,2650,3522]","[814,1550,582,452,1251]","Breach,Sova,Killjoy,Jett,Astra","Sova,Jett,Skye,Astra,Chamber",1588
55974,25389,"VCT Korea 2022 - Stage 1 Challengers : Group Stage","Breeze",1515,"World Game Star",286,"DRX",1,3,13,3,9,0,0,0,3,9,0,4,2,1,1,4,0,9,3,"standard","2022-02-25T00:00:00.000Z","[293,3522,2650,2687,23167]","[814,452,1550,582,1251]","Sova,Viper,Jett,KAY/O,Chamber","Sova,Viper,Jett,Skye,Chamber",1588
55973,25388,"VCT Korea 2022 - Stage 1 Challengers : Group Stage","Breeze",5373,"On Sla2ers",6366,"Maru Gaming",2,13,0,12,0,2,1,1,1,0,12,0,0,0,0,0,12,0,1,"standard","2022-02-24T00:00:00.000Z","[2151,1199,2009,1075,2904]","[6719,6740,18837,8382,4229]","Cypher,Sova,Viper,Jett,KAY/O","Sova,Viper,Sage,Jett,Chamber",1588
55972,25388,"VCT Korea 2022 - Stage 1 Challengers : Group Stage","Split",5373,"On Sla2ers",6366,"Maru Gaming",2,10,13,4,8,2,1,1,6,5,4,8,0,0,0,8,4,5,6,"standard","2022-02-24T00:00:00.000Z","[2151,2904,1075,1199,2009]","[6719,8382,18837,6740,4229]","Viper,Sage,Jett,Skye,Astra","Viper,Jett,Skye,Astra,Chamber",1588
55971,25388,"VCT Korea 2022 - Stage 1 Challengers : Group Stage","Bind",5373,"On Sla2ers",6366,"Maru Gaming",1,13,6,11,1,1,1,0,11,1,2,5,1,1,0,5,2,1,11,"standard","2022-02-24T00:00:00.000Z","[1075,2151,2904,1199,2009]","[6719,8382,18837,6740,4229]","Raze,Viper,Sage,Skye,Astra","Viper,Jett,Skye,Astra,Chamber",1588
55969,25387,"VCT Korea 2022 - Stage 1 Challengers : Group Stage","Fracture",6510,"HolyMolly",997,"DAMWON Gaming",1,12,14,8,4,1,1,0,8,5,4,9,1,1,0,9,4,5,8,"standard","2022-02-24T00:00:00.000Z","[3186,1810,2908,2508,15725]","[2240,4811,2368,2762,1406]","Breach,Cypher,Brimstone,Sage,Neon","Breach,Raze,Sage,Astra,Chamber",1588
55968,25387,"VCT Korea 2022 - Stage 1 Challengers : Group Stage","Haven",6510,"HolyMolly",997,"DAMWON Gaming",1,5,13,4,8,0,0,0,4,8,1,5,2,1,1,5,1,8,4,"standard","2022-02-24T00:00:00.000Z","[3186,2508,15725,1810,2908]","[2368,1406,4811,2240,2762]","Breach,Skye,Astra,Chamber,Neon","Sova,Killjoy,Jett,Skye,Astra",1588
55966,25386,"VCT Korea 2022 - Stage 1 Challengers : Group Stage","Ascent",286,"DRX",6360,"Desperado",2,13,0,12,0,2,1,1,1,0,12,0,0,0,0,0,12,0,1,"standard","2022-02-23T00:00:00.000Z","[814,1550,582,452,1251]","[227,6690,19177,18866,3523]","Sova,Jett,Skye,Astra,Chamber","Sova,Killjoy,Jett,Astra,KAY/O",1588
55965,25386,"VCT Korea 2022 - Stage 1 Challengers : Group Stage","Breeze",286,"DRX",6360,"Desperado",1,13,3,10,2,2,1,1,10,2,3,1,0,0,0,1,3,2,10,"standard","2022-02-23T00:00:00.000Z","[814,452,1550,582,1251]","[6690,18866,227,19177,3523]","Sova,Viper,Jett,Skye,Chamber","Sova,Viper,Reyna,Jett,Neon",1588
55964,25385,"VCT Korea 2022 - Stage 1 Challengers : Group Stage","Haven",1515,"World Game Star",6368,"Team T5",2,13,4,9,3,1,0,1,4,1,9,3,1,0,1,3,9,1,4,"standard","2022-02-23T00:00:00.000Z","[2687,293,23167,2650,3522]","[6595,1512,6546,8058,6549]","Breach,Sova,Killjoy,Jett,Astra","Sova,Omen,Jett,KAY/O,Chamber",1588
55963,25385,"VCT Korea 2022 - Stage 1 Challengers : Group Stage","Ascent",1515,"World Game Star",6368,"Team T5",2,9,13,6,6,1,0,1,3,7,6,6,1,0,1,6,6,7,3,"standard","2022-02-23T00:00:00.000Z","[2687,293,23167,2650,3522]","[6595,6549,6546,1512,8058]","Breach,Sova,Killjoy,Jett,Astra","Sova,Killjoy,Reyna,Omen,KAY/O",1588
55962,25385,"VCT Korea 2022 - Stage 1 Challengers : Group Stage","Bind",1515,"World Game Star",6368,"Team T5",1,13,6,7,5,1,0,1,7,5,6,1,1,0,1,1,6,5,7,"standard","2022-02-23T00:00:00.000Z","[23167,2687,293,2650,3522]","[6595,6549,6546,8058,1512]","Breach,Raze,Sova,Jett,Astra","Raze,Viper,Jett,Skye,Astra",1588
55020,25003,"VCT Brazil 2022 - Stage 1 Challengers 1 - Group Stage","Bind",5747,"TBK Esports",580,"Gamelanders Blue",2,13,7,6,6,2,1,1,7,1,6,6,0,0,0,6,6,1,7,"standard","2022-02-21T00:00:00.000Z","[2366,2457,5580,9831,1506]","[622,739,6038,1427,4747]","Raze,Viper,Skye,Astra,Chamber","Sova,Viper,Jett,Astra,KAY/O",1588
55568,25210,"VCT North America 2022 - Stage 1 Challengers - Group Stage","Ascent",305,"100 Thieves",5201,"The Guard",1,0,13,0,12,0,0,0,0,12,0,1,2,1,1,1,0,12,0,"standard","2022-02-21T00:00:00.000Z","[588,355,10253,923,763]","[11412,4141,1091,2551,1804]","Cypher,Sova,Skye,Astra,Chamber","Sova,Killjoy,Sage,Jett,Astra",1588
55019,25003,"VCT Brazil 2022 - Stage 1 Challengers 1 - Group Stage","Ascent",5747,"TBK Esports",580,"Gamelanders Blue",2,12,14,5,7,1,0,1,7,6,5,8,1,0,1,8,5,6,7,"standard","2022-02-21T00:00:00.000Z","[2366,5580,1506,9831,2457]","[622,739,6038,1427,4747]","Breach,Sova,Jett,Astra,Chamber","Sova,Killjoy,Jett,Astra,KAY/O",1588
55567,25210,"VCT North America 2022 - Stage 1 Challengers - Group Stage","Split",305,"100 Thieves",5201,"The Guard",1,13,6,6,6,1,0,1,6,6,7,0,1,0,1,0,7,6,6,"standard","2022-02-21T00:00:00.000Z","[763,588,355,10253,923]","[2551,11412,1091,1804,4141]","Raze,Cypher,Viper,Skye,Astra","Raze,Viper,Skye,Astra,Chamber",1588
55018,25003,"VCT Brazil 2022 - Stage 1 Challengers 1 - Group Stage","Split",5747,"TBK Esports",580,"Gamelanders Blue",1,13,10,4,8,1,0,1,4,8,9,2,1,0,1,2,9,8,4,"standard","2022-02-20T00:00:00.000Z","[2366,2457,5580,9831,1506]","[739,622,6038,4747,1427]","Raze,Viper,Skye,Astra,Chamber","Cypher,Viper,Jett,Skye,Astra",1588
55566,25210,"VCT North America 2022 - Stage 1 Challengers - Group Stage","Haven",305,"100 Thieves",5201,"The Guard",2,12,14,2,10,1,1,0,10,3,2,11,1,1,0,11,2,3,10,"standard","2022-02-20T00:00:00.000Z","[588,355,763,10253,923]","[11412,4141,2551,1091,1804]","Cypher,Sova,Jett,Skye,Astra","Sova,Killjoy,Jett,Skye,Astra",1588
55599,25221,"VCT LATAM South 2022 - Stage 1 Challengers 1 - Group Stage","Ascent",738,"Leviatán",683,"9z Team",1,13,1,11,1,2,1,1,11,1,2,0,0,0,0,0,2,1,11,"standard","2022-02-20T00:00:00.000Z","[3531,3555,3532,3421,6414]","[1376,855,3506,9905,3510]","Sova,Killjoy,Jett,Astra,KAY/O","Sova,Killjoy,Jett,Astra,KAY/O",1588
55017,25002,"VCT Brazil 2022 - Stage 1 Challengers 1 - Group Stage","Ascent",319,"Liberty",6344,"LOUD",1,11,13,6,6,0,0,0,6,6,5,7,2,1,1,7,5,6,6,"standard","2022-02-20T00:00:00.000Z","[2927,4745,2054,937,986]","[2294,4746,4748,6037,2895]","Breach,Raze,Sova,Omen,Astra","Sova,Killjoy,Jett,Astra,KAY/O",1588
55570,25211,"VCT North America 2022 - Stage 1 Challengers - Group Stage","Fracture",116,"NRG Esports",6426,"OpTic Gaming",2,5,13,1,11,1,1,0,4,2,1,11,1,1,0,11,1,2,4,"standard","2022-02-20T00:00:00.000Z","[1597,493,165,1232,1763]","[2841,3211,2483,398,2716]","Breach,Viper,Jett,Astra,Chamber","Breach,Raze,Viper,Astra,Chamber",1588
55569,25211,"VCT North America 2022 - Stage 1 Challengers - Group Stage","Icebox",116,"NRG Esports",6426,"OpTic Gaming",1,7,13,4,8,1,0,1,4,8,3,5,1,0,1,5,3,8,4,"standard","2022-02-20T00:00:00.000Z","[1597,1232,1763,165,493]","[2483,398,2841,3211,2716]","Sova,Viper,Reyna,Jett,Chamber","Sova,Viper,Sage,KAY/O,Chamber",1588
55016,25002,"VCT Brazil 2022 - Stage 1 Challengers 1 - Group Stage","Fracture",319,"Liberty",6344,"LOUD",1,13,11,6,6,2,1,1,6,6,7,5,0,0,0,5,7,6,6,"standard","2022-02-20T00:00:00.000Z","[2927,4745,986,2054,937]","[2294,4748,2895,4746,6037]","Breach,Raze,Cypher,Viper,Astra","Breach,Raze,Cypher,Viper,Astra",1588
55598,25221,"VCT LATAM South 2022 - Stage 1 Challengers 1 - Group Stage","Haven",738,"Leviatán",683,"9z Team",2,15,13,2,10,1,1,0,12,2,3,11,1,1,0,11,3,2,12,"standard","2022-02-20T00:00:00.000Z","[6414,3555,3531,3532,3421]","[3510,1376,855,3506,9905]","Breach,Cypher,Sova,Jett,Astra","Breach,Sova,Killjoy,Jett,Astra",1588
55015,25002,"VCT Brazil 2022 - Stage 1 Challengers 1 - Group Stage","Haven",319,"Liberty",6344,"LOUD",2,5,13,4,8,0,0,0,1,5,4,8,2,1,1,8,4,5,1,"standard","2022-02-20T00:00:00.000Z","[986,2054,937,4745,2927]","[2294,4746,4748,6037,2895]","Cypher,Sova,Jett,Astra,KAY/O","Sova,Killjoy,Jett,Astra,KAY/O",1588
55596,25220,"VCT LATAM South 2022 - Stage 1 Challengers 1 - Group Stage","Breeze",5305,"EBRO Gaming",1052,"Meta Gaming",1,13,10,3,9,1,0,1,3,9,10,1,1,0,1,1,10,9,3,"standard","2022-02-20T00:00:00.000Z","[5831,3507,4791,4605,4061]","[2781,4629,18848,4618,1579]","Cypher,Sova,Viper,Jett,Skye","Sova,Viper,Reyna,Jett,Chamber",1588
54875,24952,"VCT EMEA 2022 - Stage 1 Challengers - Group Stage","Split",4220,"Natus Vincere",224,"Team Liquid",2,10,13,4,8,1,0,1,6,5,4,8,1,0,1,8,4,5,6,"standard","2022-02-20T00:00:00.000Z","[999,2279,2154,3003,2983]","[10211,2056,17788,1690,1403]","Raze,Killjoy,Viper,Astra,KAY/O","Breach,Raze,Cypher,Sage,Astra",1588
55595,25220,"VCT LATAM South 2022 - Stage 1 Challengers 1 - Group Stage","Ascent",5305,"EBRO Gaming",1052,"Meta Gaming",2,13,7,9,3,1,1,0,4,4,9,3,1,1,0,3,9,4,4,"standard","2022-02-20T00:00:00.000Z","[3507,5831,4605,4061,4791]","[4629,4618,2781,18848,1579]","Sova,Killjoy,Jett,Skye,Astra","Sova,Jett,Astra,KAY/O,Chamber",1588
54874,24952,"VCT EMEA 2022 - Stage 1 Challengers - Group Stage","Bind",4220,"Natus Vincere",224,"Team Liquid",2,13,10,5,7,1,1,0,8,3,5,7,1,1,0,7,5,3,8,"standard","2022-02-20T00:00:00.000Z","[2983,2279,999,3003,2154]","[2056,17788,10211,1403,1690]","Sova,Viper,Jett,Astra,KAY/O","Breach,Cypher,Sova,Viper,Sage",1588
54873,24952,"VCT EMEA 2022 - Stage 1 Challengers - Group Stage","Haven",4220,"Natus Vincere",224,"Team Liquid",1,9,13,5,7,2,1,1,5,7,4,6,0,0,0,6,4,7,5,"standard","2022-02-20T00:00:00.000Z","[2279,999,2983,3003,2154]","[1690,1403,17788,10211,2056]","Cypher,Jett,Skye,Astra,KAY/O","Skye,Astra,KAY/O,Chamber,Neon",1588
54877,24953,"VCT EMEA 2022 - Stage 1 Challengers - Group Stage","Haven",194,"G2 Esports (Inactive)",3540,"SuperMassive",2,13,10,5,7,1,1,0,8,3,5,7,1,1,0,7,5,3,8,"standard","2022-02-20T00:00:00.000Z","[2594,2377,1826,2940,2769]","[3725,9642,2969,9640,3233]","Breach,Cypher,Sova,Jett,Astra","Breach,Sova,Killjoy,Jett,Astra",1588
54876,24953,"VCT EMEA 2022 - Stage 1 Challengers - Group Stage","Split",194,"G2 Esports (Inactive)",3540,"SuperMassive",1,13,9,4,8,1,0,1,4,8,9,1,1,0,1,1,9,8,4,"standard","2022-02-20T00:00:00.000Z","[1826,2377,2594,2769,2940]","[2969,3725,9640,9642,3233]","Raze,Cypher,Sage,Omen,Jett","Viper,Sage,Jett,Skye,Astra",1588
55037,25009,"VCT North America 2022 - Stage 1 Challengers - Group Stage","Fracture",281,"Rise",1931,"Version1 (Inactive)",2,6,13,4,8,1,1,0,2,5,4,8,1,1,0,8,4,5,2,"standard","2022-02-20T00:00:00.000Z","[269,2091,1994,1990,2105]","[3056,440,7025,3798,3352]","Breach,Raze,Viper,Astra,Chamber","Breach,Raze,Viper,Astra,Chamber",1588
55036,25009,"VCT North America 2022 - Stage 1 Challengers - Group Stage","Breeze",281,"Rise",1931,"Version1 (Inactive)",2,6,13,3,9,1,1,0,3,4,3,9,1,1,0,9,3,4,3,"standard","2022-02-20T00:00:00.000Z","[269,1994,2105,2091,1990]","[7025,3056,3798,3352,440]","Sova,Viper,Jett,KAY/O,Chamber","Cypher,Sova,Viper,Jett,KAY/O",1588
55025,25005,"VCT Brazil 2022 - Stage 1 Challengers 1 - Group Stage","Icebox",1264,"FURIA",72,"INGAMING Esports",1,16,14,6,6,2,1,1,8,7,8,7,0,0,0,7,8,7,8,"standard","2022-02-19T00:00:00.000Z","[2752,6039,18192,2423,2749]","[242,4771,177,462,9801]","Sova,Viper,Sage,Jett,Chamber","Sova,Viper,Sage,Jett,Chamber",1588
55032,25007,"VCT North America 2022 - Stage 1 Challengers - Group Stage","Icebox",603,"XSET",141,"Cloud9",2,10,13,6,6,2,1,1,4,7,6,6,0,0,0,6,6,7,4,"standard","2022-02-19T00:00:00.000Z","[3582,3346,3062,1802,494]","[1961,4639,3599,13591,2213]","Raze,Sova,Viper,Jett,Chamber","Sova,Viper,Jett,KAY/O,Chamber",1588
55024,25005,"VCT Brazil 2022 - Stage 1 Challengers 1 - Group Stage","Ascent",1264,"FURIA",72,"INGAMING Esports",1,13,6,9,3,0,0,0,9,3,4,3,2,1,1,3,4,3,9,"standard","2022-02-19T00:00:00.000Z","[2752,2749,2423,6039,18192]","[177,242,462,4771,9801]","Sova,Killjoy,Jett,Astra,KAY/O","Cypher,Sova,Jett,Astra,KAY/O",1588
55031,25007,"VCT North America 2022 - Stage 1 Challengers - Group Stage","Breeze",603,"XSET",141,"Cloud9",2,7,13,5,7,1,0,1,2,6,5,7,1,0,1,7,5,6,2,"standard","2022-02-19T00:00:00.000Z","[3346,3062,1802,494,3582]","[2213,1961,4639,3599,13591]","Sova,Viper,Jett,Astra,KAY/O","Cypher,Sova,Viper,Jett,KAY/O",1588
55013,25001,"VCT LATAM South 2022 - Stage 1 Challengers 1 - Group Stage","Bind",1503,"Movistar Optix",1052,"Meta Gaming",1,13,10,8,4,1,0,1,8,4,5,6,1,0,1,6,5,4,8,"standard","2022-02-19T00:00:00.000Z","[14764,3409,14762,4619,3411]","[18848,4629,1579,4618,2781]","Raze,Viper,Skye,Astra,Chamber","Raze,Viper,Sage,Skye,Astra",1588
55030,25007,"VCT North America 2022 - Stage 1 Challengers - Group Stage","Bind",603,"XSET",141,"Cloud9",1,13,7,5,7,1,0,1,5,7,8,0,1,0,1,0,8,7,5,"standard","2022-02-19T00:00:00.000Z","[3582,3346,3062,1802,494]","[13591,1961,3599,4639,2213]","Raze,Sova,Viper,Jett,Astra","Raze,Sova,Viper,Astra,Chamber",1588
55012,25001,"VCT LATAM South 2022 - Stage 1 Challengers 1 - Group Stage","Ascent",1503,"Movistar Optix",1052,"Meta Gaming",2,13,8,8,4,0,0,0,5,4,8,4,2,1,1,4,8,4,5,"standard","2022-02-19T00:00:00.000Z","[3409,4619,14764,3411,14762]","[4629,4618,2781,18848,1579]","Sova,Killjoy,Jett,Astra,KAY/O","Sova,Jett,Astra,KAY/O,Chamber",1588
55022,25004,"VCT Brazil 2022 - Stage 1 Challengers 1 - Group Stage","Icebox",2564,"Sharks Esports",5750,"Ninjas in Pyjamas",1,8,13,4,8,0,0,0,4,8,4,5,2,1,1,5,4,8,4,"standard","2022-02-19T00:00:00.000Z","[1049,4688,1877,2833,1971]","[16804,3408,762,2195,3203]","Sova,Viper,Sage,Jett,KAY/O","Sova,Viper,Sage,Reyna,Jett",1588
55021,25004,"VCT Brazil 2022 - Stage 1 Challengers 1 - Group Stage","Fracture",2564,"Sharks Esports",5750,"Ninjas in Pyjamas",2,4,13,2,10,1,1,0,2,3,2,10,1,1,0,10,2,3,2,"standard","2022-02-19T00:00:00.000Z","[1971,1877,1049,2833,4688]","[762,2195,3203,3408,16804]","Breach,Cypher,Viper,Jett,Astra","Cypher,Sage,Jett,Astra,KAY/O",1588
55010,25000,"VCT LATAM South 2022 - Stage 1 Challengers 1 - Group Stage","Bind",976,"KRÜ Esports",5305,"EBRO Gaming",2,13,3,9,3,2,1,1,4,0,9,3,0,0,0,3,9,0,4,"standard","2022-02-19T00:00:00.000Z","[1725,4712,2532,4710,3535]","[3507,5831,4605,4061,4791]","Raze,Viper,Sage,Skye,Astra","Sova,Viper,Jett,Skye,Astra",1588
55009,25000,"VCT LATAM South 2022 - Stage 1 Challengers 1 - Group Stage","Haven",976,"KRÜ Esports",5305,"EBRO Gaming",2,13,7,5,7,1,1,0,8,0,5,7,1,1,0,7,5,0,8,"standard","2022-02-19T00:00:00.000Z","[4712,4710,1725,2532,3535]","[3507,5831,4605,4061,4791]","Cypher,Sova,Phoenix,Jett,Astra","Sova,Killjoy,Jett,Skye,Astra",1588
54871,24951,"VCT EMEA 2022 - Stage 1 Challengers - Group Stage","Ascent",520,"BBL Esports",1625,"FNATIC",1,10,13,6,6,1,0,1,6,6,4,7,1,0,1,7,4,6,6,"standard","2022-02-19T00:00:00.000Z","[2864,1749,9643,1852,3152]","[2290,154,2937,76,2011]","Sova,Killjoy,Jett,Astra,KAY/O","Sova,Killjoy,Jett,Astra,KAY/O",1588
54870,24951,"VCT EMEA 2022 - Stage 1 Challengers - Group Stage","Icebox",520,"BBL Esports",1625,"FNATIC",1,6,13,3,9,1,0,1,3,9,3,4,1,0,1,4,3,9,3,"standard","2022-02-19T00:00:00.000Z","[1852,1749,3152,2864,9643]","[2290,154,76,2011,2937]","Sova,Killjoy,Viper,Sage,Jett","Sova,Killjoy,Viper,Sage,Jett",1588
54869,24950,"VCT EMEA 2022 - Stage 1 Challengers - Group Stage","Breeze",2654,"LDN UTD",329,"BIG",2,13,4,8,4,1,1,0,5,0,8,4,1,1,0,4,8,0,5,"standard","2022-02-19T00:00:00.000Z","[2305,1894,2561,426,2571]","[4956,3142,1538,2326,360]","Viper,Jett,Skye,Astra,Chamber","Cypher,Sova,Viper,Jett,KAY/O",1588
54868,24950,"VCT EMEA 2022 - Stage 1 Challengers - Group Stage","Split",2654,"LDN UTD",329,"BIG",2,10,13,8,4,2,1,1,2,9,8,4,0,0,0,4,8,9,2,"standard","2022-02-19T00:00:00.000Z","[2561,1894,2571,426,2305]","[3142,1538,360,2326,4956]","Raze,Cypher,Sage,Astra,KAY/O","Breach,Cypher,Sage,Jett,Astra",1588
54867,24950,"VCT EMEA 2022 - Stage 1 Challengers - Group Stage","Haven",2654,"LDN UTD",329,"BIG",1,13,4,9,3,1,1,0,9,3,4,1,1,1,0,1,4,3,9,"standard","2022-02-19T00:00:00.000Z","[426,2561,2571,1894,2305]","[3142,1538,2326,4956,360]","Breach,Sova,Killjoy,Jett,Astra","Sova,Killjoy,Jett,Astra,KAY/O",1588
55950,25380,"VCT Japan 2022 - Stage 1 Challengers 1 : Week 1 - Open Qualifier","Haven",628,"SCARZ",740,"BLUE BEES.ESP",2,9,13,6,6,0,0,0,3,7,6,6,2,1,1,6,6,7,3,"standard","2022-02-19T00:00:00.000Z","[3128,2884,846,2114,1327]","[1212,2978,15518,3966,23136]","Breach,Sova,Killjoy,Jett,Astra","Breach,Killjoy,Jett,Skye,Astra",1588
55947,25379,"VCT Japan 2022 - Stage 1 Challengers 1 : Week 1 - Open Qualifier","Icebox",444,"Crazy Raccoon",5218,"Jadeite",1,13,7,8,4,1,1,0,8,4,5,3,1,1,0,3,5,4,8,"standard","2022-02-19T00:00:00.000Z","[1231,8025,2388,876,1886]","[147,1917,2961,1746,315]","Sova,Viper,Sage,Reyna,Jett","Sova,Viper,Sage,Jett,Chamber",1588
55946,25379,"VCT Japan 2022 - Stage 1 Challengers 1 : Week 1 - Open Qualifier","Haven",444,"Crazy Raccoon",5218,"Jadeite",2,13,5,8,4,1,1,0,5,1,8,4,1,1,0,4,8,1,5,"standard","2022-02-19T00:00:00.000Z","[1231,1886,876,8025,2388]","[2961,315,1746,147,1917]","Sova,Reyna,Jett,Astra,Chamber","Breach,Killjoy,Jett,Skye,Astra",1588
55949,25380,"VCT Japan 2022 - Stage 1 Challengers 1 : Week 1 - Open Qualifier","Ascent",628,"SCARZ",740,"BLUE BEES.ESP",2,6,13,5,7,1,0,1,1,6,5,7,1,0,1,7,5,6,1,"standard","2022-02-19T00:00:00.000Z","[2884,846,2114,1327,3128]","[2978,3966,15518,23136,1212]","Sova,Killjoy,Jett,Astra,KAY/O","Cypher,Sova,Jett,Astra,KAY/O",1588
55953,25381,"VCT Japan 2022 - Stage 1 Challengers 1 : Week 1 - Open Qualifier","Ascent",6465,"DetonatioN Gaming White",5294,"IGZIST",1,10,13,6,6,1,1,0,6,6,4,7,1,1,0,7,4,6,6,"standard","2022-02-19T00:00:00.000Z","[23147,23141,69,12244,23140]","[3521,2015,1603,2049,1401]","Sova,Killjoy,Jett,Astra,KAY/O","Sova,Killjoy,Jett,Skye,Astra",1588
55944,25378,"VCT Japan 2022 - Stage 1 Challengers 1 : Week 1 - Open Qualifier","Split",2062,"FENNEL",4081,"Storks Phalanx",1,14,12,8,4,2,1,1,9,4,5,8,0,0,0,8,5,4,9,"standard","2022-02-19T00:00:00.000Z","[391,2706,2272,8948,10]","[2897,2734,2445,2311,2198]","Breach,Raze,Killjoy,Viper,Astra","Raze,Killjoy,Viper,Skye,Astra",1588
55935,25375,"VCT Japan 2022 - Stage 1 Challengers 1 : Week 1 - Open Qualifier","Icebox",611,"ZETA DIVISION",5219,"Reignite",2,13,2,10,2,2,1,1,3,0,10,2,0,0,0,2,10,0,3,"standard","2022-02-19T00:00:00.000Z","[2699,2232,519,1593,2212]","[443,921,2849,10573,9555]","Sova,Viper,Sage,Jett,Chamber","Sova,Viper,Sage,Jett,KAY/O",1588
55952,25381,"VCT Japan 2022 - Stage 1 Challengers 1 : Week 1 - Open Qualifier","Fracture",6465,"DetonatioN Gaming White",5294,"IGZIST",2,8,13,6,6,1,0,1,2,7,6,6,1,0,1,6,6,7,2,"standard","2022-02-19T00:00:00.000Z","[69,23140,23141,23142,12244]","[2049,3521,2015,1401,1603]","Breach,Raze,Cypher,Sage,Astra","Breach,Raze,Viper,Astra,Chamber",1588
55943,25378,"VCT Japan 2022 - Stage 1 Challengers 1 : Week 1 - Open Qualifier","Icebox",2062,"FENNEL",4081,"Storks Phalanx",2,13,9,5,7,1,1,0,8,2,5,7,1,1,0,7,5,2,8,"standard","2022-02-19T00:00:00.000Z","[2272,8948,10,2706,391]","[2445,2198,2311,2734,2897]","Sova,Killjoy,Viper,Jett,Skye","Sova,Viper,Reyna,Jett,Chamber",1588
55934,25375,"VCT Japan 2022 - Stage 1 Challengers 1 : Week 1 - Open Qualifier","Split",611,"ZETA DIVISION",5219,"Reignite",2,13,5,10,2,1,0,1,3,3,10,2,1,0,1,2,10,3,3,"standard","2022-02-19T00:00:00.000Z","[519,2212,1593,2699,2232]","[443,921,9555,10573,2849]","Raze,Viper,Sage,Skye,Astra","Breach,Killjoy,Viper,Jett,Astra",1588
55957,25382,"VCT Japan 2022 - Stage 1 Challengers 1 : Week 1 - Open Qualifier","Icebox",2304,"Hexad",206,"Sengoku Gaming",1,2,13,2,10,0,0,0,2,10,0,3,2,1,1,3,0,10,2,"standard","2022-02-19T00:00:00.000Z","[1781,2792,1967,2341,371]","[15602,2291,9539,9540,6773]","Sova,Viper,Sage,Jett,Chamber","Sova,Killjoy,Viper,Sage,Jett",1588
55956,25382,"VCT Japan 2022 - Stage 1 Challengers 1 : Week 1 - Open Qualifier","Ascent",2304,"Hexad",206,"Sengoku Gaming",2,13,2,10,2,2,1,1,3,0,10,2,0,0,0,2,10,0,3,"standard","2022-02-19T00:00:00.000Z","[1781,2792,371,2341,1967]","[2291,6773,9540,9539,15602]","Sova,Killjoy,Reyna,Jett,Astra","Cypher,Jett,Skye,Astra,Neon",1588
55938,25376,"VCT Japan 2022 - Stage 1 Challengers 1 : Week 1 - Open Qualifier","Ascent",1840,"NORTHEPTION",488,"FAV gaming",2,13,10,7,5,0,0,0,6,5,7,5,2,1,1,5,7,5,6,"standard","2022-02-19T00:00:00.000Z","[652,3968,12341,8882,3060]","[9576,8883,314,3035,1824]","Sova,Killjoy,Jett,Astra,KAY/O","Sova,Killjoy,Jett,Astra,KAY/O",1588
55941,25377,"VCT Japan 2022 - Stage 1 Challengers 1 : Week 1 - Open Qualifier","Haven",2227,"IXA",334,"REJECT",2,6,13,5,7,0,0,0,1,6,5,7,2,1,1,7,5,6,1,"standard","2022-02-19T00:00:00.000Z","[9531,9528,9527,18387,18388]","[2584,802,852,3011,2791]","Breach,Sova,Jett,Astra,Chamber","Sova,Sage,Jett,Skye,Astra",1588
55955,25382,"VCT Japan 2022 - Stage 1 Challengers 1 : Week 1 - Open Qualifier","Haven",2304,"Hexad",206,"Sengoku Gaming",1,3,13,1,11,0,0,0,1,11,2,2,2,1,1,2,2,11,1,"standard","2022-02-19T00:00:00.000Z","[1781,2341,2792,1967,371]","[9540,2291,6773,15602,9539]","Breach,Jett,Skye,Astra,Chamber","Breach,Killjoy,Jett,Skye,Astra",1588
55937,25376,"VCT Japan 2022 - Stage 1 Challengers 1 : Week 1 - Open Qualifier","Bind",1840,"NORTHEPTION",488,"FAV gaming",2,13,10,10,2,2,1,1,3,8,10,2,0,0,0,2,10,8,3,"standard","2022-02-19T00:00:00.000Z","[3060,8882,12341,652,3968]","[8883,1824,314,9576,3035]","Breach,Viper,Jett,Skye,Astra","Breach,Raze,Jett,Skye,Astra",1588
55940,25377,"VCT Japan 2022 - Stage 1 Challengers 1 : Week 1 - Open Qualifier","Icebox",2227,"IXA",334,"REJECT",2,1,13,1,11,0,0,0,0,2,1,11,2,1,1,11,1,2,0,"standard","2022-02-19T00:00:00.000Z","[9531,9528,18387,9527,18388]","[3011,2791,802,852,2584]","Sova,Killjoy,Viper,Reyna,Jett","Sova,Viper,Sage,Jett,Chamber",1588
55029,25006,"VCT North America 2022 - Stage 1 Challengers - Group Stage","Breeze",1448,"Evil Geniuses",279,"Luminosity Gaming",1,12,14,3,9,1,0,1,3,10,9,4,1,0,1,4,9,10,3,"standard","2022-02-19T00:00:00.000Z","[102,11672,1023,4157,722]","[3345,2489,1522,905,1801]","Sova,Viper,Jett,KAY/O,Chamber","Cypher,Sova,Viper,Jett,Skye",1588
55028,25006,"VCT North America 2022 - Stage 1 Challengers - Group Stage","Split",1448,"Evil Geniuses",279,"Luminosity Gaming",1,13,11,4,8,1,0,1,4,8,9,3,1,0,1,3,9,8,4,"standard","2022-02-19T00:00:00.000Z","[4157,11672,1023,102,722]","[1801,3345,905,2489,1522]","Raze,Viper,Skye,Astra,Chamber","Raze,Cypher,Sage,Skye,Astra",1588
55027,25006,"VCT North America 2022 - Stage 1 Challengers - Group Stage","Bind",1448,"Evil Geniuses",279,"Luminosity Gaming",2,2,13,2,10,0,0,0,0,3,2,10,2,1,1,10,2,3,0,"standard","2022-02-19T00:00:00.000Z","[4157,722,11672,1023,102]","[1801,2489,3345,1522,905]","Raze,Sova,Viper,Skye,Astra","Raze,Sova,Viper,Astra,Chamber",1588
55035,25008,"VCT North America 2022 - Stage 1 Challengers - Group Stage","Haven",588,"Knights",388,"Sentinels",2,8,13,4,8,1,1,0,4,5,4,8,1,1,0,8,4,5,4,"standard","2022-02-18T00:00:00.000Z","[2810,3894,835,3340,3831]","[893,3033,1614,1485,724]","Sova,Killjoy,Jett,Skye,Astra","Sova,Jett,Skye,Astra,Chamber",1588
55034,25008,"VCT North America 2022 - Stage 1 Challengers - Group Stage","Bind",588,"Knights",388,"Sentinels",2,5,13,3,9,1,1,0,2,4,3,9,1,1,0,9,3,4,2,"standard","2022-02-18T00:00:00.000Z","[835,2810,3831,3340,3894]","[1614,893,724,3033,1485]","Raze,Sova,Viper,Skye,Astra","Raze,Sova,Viper,Jett,Astra",1588
55033,25008,"VCT North America 2022 - Stage 1 Challengers - Group Stage","Ascent",588,"Knights",388,"Sentinels",1,15,13,6,6,1,1,0,7,7,8,6,1,1,0,6,8,7,7,"standard","2022-02-18T00:00:00.000Z","[2810,3894,835,3340,3831]","[893,724,3033,1485,1614]","Sova,Killjoy,Sage,Jett,Astra","Sova,Killjoy,Jett,Astra,KAY/O",1588
54866,24949,"VCT EMEA 2022 - Stage 1 Challengers - Group Stage","Fracture",386,"Guild Esports",2597,"Acend",2,13,4,9,3,1,1,0,4,1,9,3,1,1,0,3,9,1,4,"standard","2022-02-18T00:00:00.000Z","[449,966,2318,1834,2321]","[3208,2391,1334,691,732]","Breach,Raze,Cypher,Jett,Astra","Breach,Viper,Brimstone,Jett,Chamber",1588
54865,24949,"VCT EMEA 2022 - Stage 1 Challengers - Group Stage","Breeze",386,"Guild Esports",2597,"Acend",2,13,9,8,4,2,1,1,5,5,8,4,0,0,0,4,8,5,5,"standard","2022-02-18T00:00:00.000Z","[966,449,2321,1834,2318]","[1334,691,3208,2391,732]","Cypher,Sova,Viper,Jett,Skye","Sova,Viper,Astra,KAY/O,Chamber",1588
54864,24949,"VCT EMEA 2022 - Stage 1 Challengers - Group Stage","Split",386,"Guild Esports",2597,"Acend",2,11,13,9,3,1,0,1,2,10,9,3,1,0,1,3,9,10,2,"standard","2022-02-18T00:00:00.000Z","[966,449,1834,2318,2321]","[2391,3208,691,1334,732]","Cypher,Viper,Jett,Skye,Astra","Raze,Cypher,Sage,Omen,Jett",1588
54863,24948,"VCT EMEA 2022 - Stage 1 Challengers - Group Stage","Icebox",17,"FunPlus Phoenix",255,"Gambit Esports",2,14,12,8,4,1,0,1,5,8,9,4,1,0,1,4,9,8,5,"standard","2022-02-18T00:00:00.000Z","[2335,2225,2359,1256,3043]","[1964,274,1081,3135,2528]","Sova,Viper,Sage,KAY/O,Chamber","Sova,Viper,Sage,Jett,KAY/O",1588
54862,24948,"VCT EMEA 2022 - Stage 1 Challengers - Group Stage","Bind",17,"FunPlus Phoenix",255,"Gambit Esports",1,6,13,2,10,1,0,1,2,10,4,3,1,0,1,3,4,10,2,"standard","2022-02-18T00:00:00.000Z","[2335,1256,3043,2225,2359]","[3135,1081,274,2528,1964]","Breach,Raze,Jett,Skye,Astra","Raze,Viper,Brimstone,Sage,Skye",1588
54861,24948,"VCT EMEA 2022 - Stage 1 Challengers - Group Stage","Fracture",17,"FunPlus Phoenix",255,"Gambit Esports",1,17,15,9,3,2,1,1,10,6,7,9,0,0,0,9,7,6,10,"standard","2022-02-18T00:00:00.000Z","[2335,1256,2225,3043,2359]","[1964,3135,1081,274,2528]","Breach,Raze,Cypher,Jett,Astra","Breach,Raze,Cypher,Brimstone,Sage",1588
55228,25073,"VCT Japan 2022 - Stage 1 Challengers 1 : Week 1 - Open Qualifier","Icebox",2304,"Hexad",483,"Crest Gaming ZST",1,17,15,6,6,0,0,0,9,7,8,8,2,1,1,8,8,7,9,"standard","2022-02-17T00:00:00.000Z","[1781,2792,1967,371,2341]","[2109,12262,23152,3020,146]","Sova,Viper,Sage,Reyna,Jett","Sova,Viper,Reyna,Jett,Chamber",1588
55213,25068,"VCT Japan 2022 - Stage 1 Challengers 1 : Week 1 - Open Qualifier","Haven",449,"DeToNator",628,"SCARZ",1,10,13,5,7,1,0,1,5,7,5,6,1,0,1,6,5,7,5,"standard","2022-02-17T00:00:00.000Z","[805,9583,1422,12250,15603]","[3128,2884,846,2114,1327]","Breach,Killjoy,Jett,Skye,Astra","Breach,Sova,Killjoy,Jett,Astra",1588
55195,25062,"VCT Japan 2022 - Stage 1 Challengers 1 : Week 1 - Open Qualifier","Breeze",6459,"EVA:e",2227,"IXA",2,9,13,3,9,0,0,0,6,4,3,9,2,1,1,9,3,4,6,"standard","2022-02-17T00:00:00.000Z","[2764,23096,2055,506,9553]","[9531,18387,9527,18388,9528]","Sova,Viper,Skye,Astra,Chamber","Sova,Viper,Jett,Skye,Chamber",1588
55207,25066,"VCT Japan 2022 - Stage 1 Challengers 1 : Week 1 - Open Qualifier","Bind",444,"Crazy Raccoon",4061,"Insomnia",2,13,6,7,5,1,1,0,6,1,7,5,1,1,0,5,7,1,6,"standard","2022-02-17T00:00:00.000Z","[876,1231,1886,8025,2388]","[9589,15639,6715,23105,15552]","Breach,Sova,Jett,Astra,Chamber","Raze,Sova,Jett,Skye,Astra",1588
55212,25068,"VCT Japan 2022 - Stage 1 Challengers 1 : Week 1 - Open Qualifier","Ascent",449,"DeToNator",628,"SCARZ",1,13,11,5,7,0,0,0,5,7,8,4,2,1,1,4,8,7,5,"standard","2022-02-17T00:00:00.000Z","[9583,805,1422,15603,12250]","[2884,846,2114,1327,3128]","Sova,Killjoy,Jett,Astra,KAY/O","Sova,Killjoy,Jett,Astra,KAY/O",1588
55203,25065,"VCT Japan 2022 - Stage 1 Challengers 1 : Week 1 - Open Qualifier","Split",6460,"ややーず",4081,"Storks Phalanx",1,11,13,7,5,2,1,1,7,5,4,8,0,0,0,8,4,5,7,"standard","2022-02-17T00:00:00.000Z","[12251,1244,9552,18858,9561]","[2897,2734,2445,2311,2198]","Raze,Cypher,Sage,Jett,Astra","Raze,Killjoy,Viper,Skye,Astra",1588
55227,25073,"VCT Japan 2022 - Stage 1 Challengers 1 : Week 1 - Open Qualifier","Ascent",2304,"Hexad",483,"Crest Gaming ZST",1,6,13,5,7,0,0,0,5,7,1,6,2,1,1,6,1,7,5,"standard","2022-02-17T00:00:00.000Z","[1781,2792,371,2341,1967]","[2109,3020,23152,146,12262]","Sova,Killjoy,Reyna,Jett,Astra","Cypher,Sova,Jett,Skye,Astra",1588
55197,25063,"VCT Japan 2022 - Stage 1 Challengers 1 : Week 1 - Open Qualifier","Icebox",4200,"Rebellion Arts",334,"REJECT",1,3,13,3,9,1,1,0,3,9,0,4,1,1,0,4,0,9,3,"standard","2022-02-17T00:00:00.000Z","[15995,10685,23098,23097,10682]","[3011,2791,802,852,2584]","Sova,Viper,Sage,Reyna,Jett","Sova,Viper,Sage,Jett,Chamber",1588
55194,25062,"VCT Japan 2022 - Stage 1 Challengers 1 : Week 1 - Open Qualifier","Haven",6459,"EVA:e",2227,"IXA",1,14,12,4,8,1,1,0,5,8,9,4,1,1,0,4,9,8,5,"standard","2022-02-17T00:00:00.000Z","[2055,23096,2764,506,9553]","[9531,9528,9527,18387,18388]","Breach,Raze,Skye,Astra,Chamber","Breach,Sova,Jett,Astra,Chamber",1588
55215,25069,"VCT Japan 2022 - Stage 1 Challengers 1 : Week 1 - Open Qualifier","Split",740,"BLUE BEES.ESP",6463,"looking for a name",1,13,3,10,2,2,1,1,10,2,3,1,0,0,0,1,3,2,10,"standard","2022-02-17T00:00:00.000Z","[2978,1212,15518,3966,23136]","[15578,15534,15535,23135,15536]","Killjoy,Sage,Jett,Skye,Astra","Raze,Viper,Reyna,Skye,Astra",1588
55230,25074,"VCT Japan 2022 - Stage 1 Challengers 1 : Week 1 - Open Qualifier","Bind",5219,"Reignite",6468,"Focus e-Sports",1,13,3,9,3,2,1,1,9,3,4,0,0,0,0,0,4,3,9,"standard","2022-02-17T00:00:00.000Z","[443,921,10573,9555,2849]","[23156,23155,23154,23153,15598]","Sova,Viper,Jett,Skye,Astra","Viper,Jett,Skye,Astra,Chamber",1588
55233,25075,"VCT Japan 2022 - Stage 1 Challengers 1 : Week 1 - Open Qualifier","Icebox",2229,"SETOUCHI ENLIFE",611,"ZETA DIVISION",1,1,13,1,11,0,0,0,1,11,0,2,2,1,1,2,0,11,1,"standard","2022-02-17T00:00:00.000Z","[23157,23158,15629,10689,8884]","[2699,2232,519,1593,2212]","Raze,Sova,Viper,Jett,Chamber","Sova,Viper,Sage,Jett,Chamber",1588
55209,25067,"VCT Japan 2022 - Stage 1 Challengers 1 : Week 1 - Open Qualifier","Icebox",6462,"K2 eSports",5218,"Jadeite",1,6,13,6,6,1,1,0,6,6,0,7,1,1,0,7,0,6,6,"standard","2022-02-17T00:00:00.000Z","[15609,23132,15558,23134,12282]","[147,1917,2961,1746,315]","Raze,Sova,Viper,Sage,Jett","Sova,Viper,Sage,Jett,Chamber",1588
55224,25072,"VCT Japan 2022 - Stage 1 Challengers 1 : Week 1 - Open Qualifier","Fracture",6509,"GyoGun",206,"Sengoku Gaming",2,4,13,3,9,0,0,0,1,4,3,9,2,1,1,9,3,4,1,"standard","2022-02-17T00:00:00.000Z","[1643,23149,23151,3497,23150]","[9540,2291,9539,6773,15602]","Breach,Viper,Reyna,Jett,Astra","Breach,Raze,Astra,Chamber,Neon",1588
55236,25076,"VCT Japan 2022 - Stage 1 Challengers 1 : Week 1 - Open Qualifier","Haven",6469,"AWS",488,"FAV gaming",1,1,13,1,11,0,0,0,1,11,0,2,2,1,1,2,0,11,1,"standard","2022-02-17T00:00:00.000Z","[23161,15547,15550,23160,15548]","[9576,8883,1824,314,3035]","Cypher,Sova,Jett,Skye,Astra","Cypher,Sova,Reyna,Jett,Astra",1588
55239,25077,"VCT Japan 2022 - Stage 1 Challengers 1 : Week 1 - Open Qualifier","Ascent",1840,"NORTHEPTION",4076,"SchwarzerLand",2,13,1,11,1,2,1,1,2,0,11,1,0,0,0,1,11,0,2,"standard","2022-02-17T00:00:00.000Z","[652,3968,12341,8882,3060]","[23164,23162,15590,23163,15568]","Sova,Killjoy,Jett,Astra,KAY/O","Sova,Killjoy,Jett,Astra,KAY/O",1588
55200,25064,"VCT Japan 2022 - Stage 1 Challengers 1 : Week 1 - Open Qualifier","Fracture",6461,"TRIDENT",2062,"FENNEL",2,9,13,7,5,1,0,1,2,8,7,5,1,0,1,5,7,8,2,"standard","2022-02-17T00:00:00.000Z","[23100,23101,23102,23104,23103]","[2272,2706,8948,391,10]","Breach,Raze,Skye,Astra,Chamber","Breach,Raze,Cypher,Sage,Astra",1588
55221,25071,"VCT Japan 2022 - Stage 1 Challengers 1 : Week 1 - Open Qualifier","Breeze",6465,"DetonatioN Gaming White",6466,"Mariner",2,13,8,7,5,1,1,0,6,3,7,5,1,1,0,5,7,3,6,"standard","2022-02-17T00:00:00.000Z","[23147,12244,23140,69,23142]","[23144,23146,23145,10683,23143]","Sova,Viper,Reyna,Jett,Skye","Sova,Viper,Reyna,KAY/O,Chamber",1588
55218,25070,"VCT Japan 2022 - Stage 1 Challengers 1 : Week 1 - Open Qualifier","Breeze",5294,"IGZIST",6464,"SYSTEM e-Sports",1,13,3,10,2,1,1,0,10,2,3,1,1,1,0,1,3,2,10,"standard","2022-02-17T00:00:00.000Z","[3521,1401,1603,2049,2015]","[13511,23137,23139,15601,23138]","Sova,Viper,Jett,KAY/O,Chamber","Sova,Viper,Jett,Skye,Chamber",1588
55206,25066,"VCT Japan 2022 - Stage 1 Challengers 1 : Week 1 - Open Qualifier","Fracture",444,"Crazy Raccoon",4061,"Insomnia",2,10,13,5,7,0,0,0,5,6,5,7,2,1,1,7,5,6,5,"standard","2022-02-17T00:00:00.000Z","[2388,1886,1231,8025,876]","[15639,15552,6715,23105,9589]","Breach,Jett,Skye,Astra,Chamber","Breach,Brimstone,Jett,KAY/O,Chamber",1588
55226,25073,"VCT Japan 2022 - Stage 1 Challengers 1 : Week 1 - Open Qualifier","Breeze",2304,"Hexad",483,"Crest Gaming ZST",2,13,9,7,5,0,0,0,6,4,7,5,2,1,1,5,7,4,6,"standard","2022-02-17T00:00:00.000Z","[1781,2792,1967,2341,371]","[146,2109,12262,3020,23152]","Sova,Viper,Reyna,Jett,Chamber","Cypher,Sova,Viper,Jett,KAY/O",1588
55223,25072,"VCT Japan 2022 - Stage 1 Challengers 1 : Week 1 - Open Qualifier","Icebox",6509,"GyoGun",206,"Sengoku Gaming",1,4,13,3,9,1,0,1,3,9,1,4,1,0,1,4,1,9,3,"standard","2022-02-17T00:00:00.000Z","[1643,23150,23149,23151,3497]","[15602,2291,9539,9540,6773]","Sova,Viper,Sage,Reyna,Jett","Sova,Killjoy,Viper,Sage,Jett",1588
55202,25065,"VCT Japan 2022 - Stage 1 Challengers 1 : Week 1 - Open Qualifier","Breeze",6460,"ややーず",4081,"Storks Phalanx",1,9,13,3,9,1,0,1,3,9,6,4,1,0,1,4,6,9,3,"standard","2022-02-17T00:00:00.000Z","[9561,9552,18858,1244,12251]","[2445,2734,2198,2897,2311]","Sova,Viper,Jett,KAY/O,Chamber","Cypher,Sova,Viper,Jett,Skye",1588
55199,25064,"VCT Japan 2022 - Stage 1 Challengers 1 : Week 1 - Open Qualifier","Split",6461,"TRIDENT",2062,"FENNEL",1,0,13,0,12,0,0,0,0,12,0,1,2,1,1,1,0,12,0,"standard","2022-02-17T00:00:00.000Z","[23101,23102,23104,23100,23103]","[391,2706,2272,8948,10]","Raze,Skye,Astra,KAY/O,Chamber","Breach,Raze,Killjoy,Viper,Astra",1588
55196,25063,"VCT Japan 2022 - Stage 1 Challengers 1 : Week 1 - Open Qualifier","Ascent",4200,"Rebellion Arts",334,"REJECT",1,9,13,7,5,1,1,0,7,5,2,8,1,1,0,8,2,5,7,"standard","2022-02-17T00:00:00.000Z","[23097,23098,10682,15995,10685]","[2584,3011,802,852,2791]","Sova,Killjoy,Jett,Skye,Astra","Sova,Killjoy,Sage,Jett,Astra",1588
55220,25071,"VCT Japan 2022 - Stage 1 Challengers 1 : Week 1 - Open Qualifier","Haven",6465,"DetonatioN Gaming White",6466,"Mariner",1,13,0,12,0,2,1,1,12,0,1,0,0,0,0,0,1,0,12,"standard","2022-02-17T00:00:00.000Z","[23142,23141,69,23140,12244]","[10683,23144,23143,23145,23146]","Breach,Killjoy,Jett,Skye,Astra","Breach,Sova,Killjoy,Jett,Astra",1588
55217,25070,"VCT Japan 2022 - Stage 1 Challengers 1 : Week 1 - Open Qualifier","Haven",5294,"IGZIST",6464,"SYSTEM e-Sports",2,13,0,12,0,2,1,1,1,0,12,0,0,0,0,0,12,0,1,"standard","2022-02-17T00:00:00.000Z","[2049,1603,3521,1401,2015]","[13511,23138,23139,15601,23137]","Breach,Jett,Skye,Astra,Chamber","Breach,Killjoy,Jett,Skye,Astra",1588
55229,25074,"VCT Japan 2022 - Stage 1 Challengers 1 : Week 1 - Open Qualifier","Icebox",5219,"Reignite",6468,"Focus e-Sports",2,13,7,7,5,1,1,0,6,2,7,5,1,1,0,5,7,2,6,"standard","2022-02-17T00:00:00.000Z","[443,921,2849,9555,10573]","[15598,23153,23154,23155,23156]","Sova,Viper,Sage,Reyna,Jett","Sova,Viper,Sage,Reyna,Jett",1588
55235,25076,"VCT Japan 2022 - Stage 1 Challengers 1 : Week 1 - Open Qualifier","Ascent",6469,"AWS",488,"FAV gaming",2,5,13,2,10,1,0,1,3,3,2,10,1,0,1,10,2,3,3,"standard","2022-02-17T00:00:00.000Z","[23161,15547,23160,15550,15548]","[9576,8883,1824,314,3035]","Cypher,Sova,Reyna,Jett,Astra","Sova,Killjoy,Reyna,Jett,Astra",1588
55211,25068,"VCT Japan 2022 - Stage 1 Challengers 1 : Week 1 - Open Qualifier","Breeze",449,"DeToNator",628,"SCARZ",1,11,13,5,7,0,0,0,5,7,6,6,2,1,1,6,6,7,5,"standard","2022-02-17T00:00:00.000Z","[1422,9583,12250,805,15603]","[2884,1327,2114,3128,846]","Cypher,Sova,Viper,Jett,Skye","Sova,Viper,Jett,Skye,Chamber",1588
55214,25069,"VCT Japan 2022 - Stage 1 Challengers 1 : Week 1 - Open Qualifier","Bind",740,"BLUE BEES.ESP",6463,"looking for a name",2,13,10,6,6,0,0,0,7,4,6,6,2,1,1,6,6,4,7,"standard","2022-02-17T00:00:00.000Z","[3966,2978,15518,1212,23136]","[15535,15534,15578,23135,15536]","Sova,Viper,Jett,Skye,Astra","Breach,Sova,Jett,Skye,Astra",1588
55232,25075,"VCT Japan 2022 - Stage 1 Challengers 1 : Week 1 - Open Qualifier","Breeze",2229,"SETOUCHI ENLIFE",611,"ZETA DIVISION",2,7,13,3,9,1,1,0,4,4,3,9,1,1,0,9,3,4,4,"standard","2022-02-17T00:00:00.000Z","[15629,8884,23158,10689,23157]","[2699,2232,1593,519,2212]","Sova,Killjoy,Viper,Jett,Skye","Sova,Viper,Jett,KAY/O,Chamber",1588
55193,25062,"VCT Japan 2022 - Stage 1 Challengers 1 : Week 1 - Open Qualifier","Split",6459,"EVA:e",2227,"IXA",2,9,13,6,6,1,0,1,3,7,6,6,1,0,1,6,6,7,3,"standard","2022-02-17T00:00:00.000Z","[2055,23096,2764,506,9553]","[18388,9531,9527,18387,9528]","Breach,Raze,Skye,Astra,Chamber","Raze,Sage,Reyna,Astra,Chamber",1588
55238,25077,"VCT Japan 2022 - Stage 1 Challengers 1 : Week 1 - Open Qualifier","Icebox",1840,"NORTHEPTION",4076,"SchwarzerLand",2,13,7,9,3,2,1,1,4,4,9,3,0,0,0,3,9,4,4,"standard","2022-02-17T00:00:00.000Z","[652,8882,3060,12341,3968]","[23164,15590,23162,23163,15568]","Sova,Viper,Sage,Jett,Chamber","Sova,Viper,Sage,Reyna,Jett",1588
55208,25067,"VCT Japan 2022 - Stage 1 Challengers 1 : Week 1 - Open Qualifier","Ascent",6462,"K2 eSports",5218,"Jadeite",2,7,13,5,7,1,0,1,2,6,5,7,1,0,1,7,5,6,2,"standard","2022-02-17T00:00:00.000Z","[23132,23134,12282,15558,15609]","[147,315,1746,2961,1917]","Sova,Killjoy,Jett,Astra,KAY/O","Sova,Killjoy,Jett,Skye,Astra",1588
55205,25066,"VCT Japan 2022 - Stage 1 Challengers 1 : Week 1 - Open Qualifier","Icebox",444,"Crazy Raccoon",4061,"Insomnia",1,13,1,11,1,2,1,1,11,1,2,0,0,0,0,0,2,1,11,"standard","2022-02-17T00:00:00.000Z","[1231,8025,2388,876,1886]","[15639,15552,23105,6715,9589]","Sova,Viper,Sage,Reyna,Jett","Sova,Viper,Sage,Reyna,Chamber",1588
54901,24961,"VCT North America 2022 - Stage 1 Challengers - Group Stage","Bind",603,"XSET",1448,"Evil Geniuses",2,13,7,8,4,0,0,0,5,3,8,4,2,1,1,4,8,3,5,"standard","2022-02-14T00:00:00.000Z","[3582,3346,3062,1802,494]","[4157,722,11672,1023,102]","Raze,Sova,Viper,Jett,Astra","Raze,Sova,Viper,Skye,Astra",1588
54556,24837,"VCT Brazil 2022 - Stage 1 Challengers 1 - Group Stage","Icebox",2564,"Sharks Esports",600,"Keyd Stars",2,7,13,4,8,0,0,0,3,5,4,8,2,1,1,8,4,5,3,"standard","2022-02-14T00:00:00.000Z","[1049,4688,1877,2833,1971]","[81,277,2901,1661,5288]","Sova,Viper,Sage,Jett,KAY/O","Sova,Killjoy,Viper,Sage,Jett",1588
54900,24961,"VCT North America 2022 - Stage 1 Challengers - Group Stage","Breeze",603,"XSET",1448,"Evil Geniuses",1,13,9,7,5,2,1,1,7,5,6,4,0,0,0,4,6,5,7,"standard","2022-02-14T00:00:00.000Z","[3346,3062,1802,494,3582]","[102,11672,1023,4157,722]","Sova,Viper,Jett,Astra,KAY/O","Sova,Viper,Jett,KAY/O,Chamber",1588
54555,24837,"VCT Brazil 2022 - Stage 1 Challengers 1 - Group Stage","Ascent",2564,"Sharks Esports",600,"Keyd Stars",1,9,13,4,8,2,1,1,4,8,5,5,0,0,0,5,5,8,4,"standard","2022-02-14T00:00:00.000Z","[1877,1049,2833,4688,1971]","[81,1661,277,5288,2901]","Cypher,Sova,Jett,Astra,KAY/O","Sova,Killjoy,Sage,Jett,Astra",1588
54554,24837,"VCT Brazil 2022 - Stage 1 Challengers 1 - Group Stage","Fracture",2564,"Sharks Esports",600,"Keyd Stars",2,13,10,5,7,0,0,0,8,3,5,7,2,1,1,7,5,3,8,"standard","2022-02-13T00:00:00.000Z","[1971,1877,1049,2833,4688]","[1661,277,5288,2901,81]","Breach,Cypher,Viper,Jett,Astra","Killjoy,Viper,Jett,Astra,KAY/O",1588
54905,24962,"VCT North America 2022 - Stage 1 Challengers - Group Stage","Ascent",6426,"OpTic Gaming",281,"Rise",1,9,13,5,7,0,0,0,5,7,4,6,2,1,1,6,4,7,5,"standard","2022-02-13T00:00:00.000Z","[2483,2841,2716,3211,398]","[269,1990,2105,1994,2091]","Sova,Killjoy,Jett,Skye,Astra","Sova,Killjoy,Jett,Astra,KAY/O",1588
54733,24900,"VCT LATAM South 2022 - Stage 1 Challengers 1 - Group Stage","Ascent",1503,"Movistar Optix",683,"9z Team",1,4,13,4,8,1,1,0,4,8,0,5,1,1,0,5,0,8,4,"standard","2022-02-13T00:00:00.000Z","[3411,4619,14762,14764,3409]","[1376,855,3506,9905,3510]","Sova,Killjoy,Sage,Jett,Astra","Sova,Killjoy,Jett,Astra,KAY/O",1588
54904,24962,"VCT North America 2022 - Stage 1 Challengers - Group Stage","Haven",6426,"OpTic Gaming",281,"Rise",1,13,11,6,6,1,0,1,6,6,7,5,1,0,1,5,7,6,6,"standard","2022-02-13T00:00:00.000Z","[2483,2841,2716,3211,398]","[1990,269,2105,1994,2091]","Sova,Killjoy,Jett,Skye,Astra","Cypher,Sova,Jett,Astra,KAY/O",1588
54559,24838,"VCT Brazil 2022 - Stage 1 Challengers 1 - Group Stage","Breeze",1264,"FURIA",5750,"Ninjas in Pyjamas",2,13,11,6,6,1,0,1,7,5,6,6,1,0,1,6,6,5,7,"standard","2022-02-13T00:00:00.000Z","[2749,2752,6039,2423,18192]","[762,16804,3408,2195,3203]","Cypher,Sova,Viper,Jett,KAY/O","Cypher,Sova,Viper,Reyna,Jett",1588
54732,24900,"VCT LATAM South 2022 - Stage 1 Challengers 1 - Group Stage","Bind",1503,"Movistar Optix",683,"9z Team",1,13,10,9,3,2,1,1,9,3,4,7,0,0,0,7,4,3,9,"standard","2022-02-13T00:00:00.000Z","[14764,3409,14762,4619,3411]","[855,1376,3510,9905,3506]","Raze,Viper,Skye,Astra,Chamber","Raze,Viper,Skye,Astra,Chamber",1588
54903,24962,"VCT North America 2022 - Stage 1 Challengers - Group Stage","Bind",6426,"OpTic Gaming",281,"Rise",2,10,13,5,7,2,1,1,5,6,5,7,0,0,0,7,5,6,5,"standard","2022-02-13T00:00:00.000Z","[3211,2483,2841,398,2716]","[2091,269,1994,1990,2105]","Raze,Sova,Viper,Astra,Chamber","Raze,Sova,Viper,Astra,Chamber",1588
54558,24838,"VCT Brazil 2022 - Stage 1 Challengers 1 - Group Stage","Icebox",1264,"FURIA",5750,"Ninjas in Pyjamas",1,11,13,8,4,1,1,0,8,4,3,9,1,1,0,9,3,4,8,"standard","2022-02-13T00:00:00.000Z","[2752,6039,18192,2423,2749]","[16804,3408,762,2195,3203]","Sova,Viper,Sage,Jett,Chamber","Sova,Viper,Sage,Reyna,Jett",1588
54731,24900,"VCT LATAM South 2022 - Stage 1 Challengers 1 - Group Stage","Haven",1503,"Movistar Optix",683,"9z Team",2,7,13,3,9,1,1,0,4,4,3,9,1,1,0,9,3,4,4,"standard","2022-02-13T00:00:00.000Z","[3411,4619,14764,14762,3409]","[3510,1376,855,3506,9905]","Sova,Killjoy,Jett,Skye,Astra","Breach,Sova,Killjoy,Jett,Astra",1588
54557,24838,"VCT Brazil 2022 - Stage 1 Challengers 1 - Group Stage","Ascent",1264,"FURIA",5750,"Ninjas in Pyjamas",1,13,9,7,5,1,0,1,7,5,6,4,1,0,1,4,6,5,7,"standard","2022-02-13T00:00:00.000Z","[2752,2749,2423,6039,18192]","[16804,762,2195,3203,3408]","Sova,Killjoy,Jett,Astra,KAY/O","Sova,Killjoy,Sage,Jett,Astra",1588
54729,24899,"VCT LATAM South 2022 - Stage 1 Challengers 1 - Group Stage","Haven",738,"Leviatán",1052,"Meta Gaming",1,13,1,11,1,2,1,1,11,1,2,0,0,0,0,0,2,1,11,"standard","2022-02-13T00:00:00.000Z","[6414,3555,3531,3532,3421]","[2781,18848,4618,4629,1579]","Breach,Cypher,Sova,Jett,Astra","Breach,Killjoy,Jett,Skye,Astra",1588
54090,24662,"VCT EMEA 2022 - Stage 1 Challengers - Group Stage","Haven",520,"BBL Esports",386,"Guild Esports",1,9,13,5,7,1,1,0,5,7,4,6,1,1,0,6,4,7,5,"standard","2022-02-13T00:00:00.000Z","[3152,4798,1749,9643,1852]","[966,1834,2318,2321,449]","Breach,Sova,Killjoy,Jett,Astra","Sova,Jett,Skye,Astra,Chamber",1588
54728,24899,"VCT LATAM South 2022 - Stage 1 Challengers 1 - Group Stage","Ascent",738,"Leviatán",1052,"Meta Gaming",2,13,4,8,4,1,1,0,5,0,8,4,1,1,0,4,8,0,5,"standard","2022-02-13T00:00:00.000Z","[3531,3555,3532,3421,6414]","[4629,4618,2781,18848,1579]","Sova,Killjoy,Jett,Astra,KAY/O","Sova,Jett,Astra,KAY/O,Chamber",1588
54089,24662,"VCT EMEA 2022 - Stage 1 Challengers - Group Stage","Breeze",520,"BBL Esports",386,"Guild Esports",2,6,13,3,9,2,1,1,3,4,3,9,0,0,0,9,3,4,3,"standard","2022-02-13T00:00:00.000Z","[1749,1852,3152,9643,4798]","[966,449,2321,1834,2318]","Cypher,Sova,Viper,Jett,Skye","Cypher,Sova,Viper,Jett,Skye",1588
54087,24661,"VCT EMEA 2022 - Stage 1 Challengers - Group Stage","Haven",4220,"Natus Vincere",2654,"LDN UTD",2,13,9,4,8,2,1,1,9,1,4,8,0,0,0,8,4,1,9,"standard","2022-02-13T00:00:00.000Z","[2279,999,2983,3003,2154]","[426,2561,2571,1894,2305]","Cypher,Jett,Skye,Astra,KAY/O","Breach,Sova,Killjoy,Jett,Astra",1588
54086,24661,"VCT EMEA 2022 - Stage 1 Challengers - Group Stage","Ascent",4220,"Natus Vincere",2654,"LDN UTD",1,13,7,11,1,1,1,0,11,1,2,6,1,1,0,6,2,1,11,"standard","2022-02-13T00:00:00.000Z","[2983,2279,999,3003,2154]","[426,2561,1894,2305,2571]","Sova,Killjoy,Jett,Astra,KAY/O","Breach,Sova,Jett,Astra,Chamber",1588
54531,24829,"VCT North America 2022 - Stage 1 Challengers - Group Stage","Fracture",5201,"The Guard",279,"Luminosity Gaming",2,15,13,4,8,2,1,1,10,4,5,9,0,0,0,9,5,4,10,"standard","2022-02-13T00:00:00.000Z","[11412,2551,1091,1804,4141]","[2489,1801,3345,1522,905]","Breach,Raze,Viper,Brimstone,Chamber","Breach,Raze,Cypher,Brimstone,Chamber",1588
54530,24829,"VCT North America 2022 - Stage 1 Challengers - Group Stage","Haven",5201,"The Guard",279,"Luminosity Gaming",1,13,1,11,1,2,1,1,11,1,2,0,0,0,0,0,2,1,11,"standard","2022-02-13T00:00:00.000Z","[11412,4141,2551,1091,1804]","[2489,1801,3345,905,1522]","Sova,Killjoy,Jett,Skye,Astra","Sova,Killjoy,Viper,Jett,Astra",1588
54529,24828,"VCT North America 2022 - Stage 1 Challengers - Group Stage","Bind",388,"Sentinels",116,"NRG Esports",2,13,9,11,1,1,0,1,2,8,11,1,1,0,1,1,11,8,2,"standard","2022-02-12T00:00:00.000Z","[1614,893,724,3033,1485]","[1597,493,165,1763,1232]","Raze,Sova,Viper,Jett,Astra","Sova,Viper,Jett,Skye,Astra",1588
54552,24836,"VCT Brazil 2022 - Stage 1 Challengers 1 - Group Stage","Icebox",53,"Team Vikings",319,"Liberty",1,7,13,6,6,1,1,0,6,6,1,7,1,1,0,7,1,6,6,"standard","2022-02-12T00:00:00.000Z","[181,2607,13153,2894,1159]","[2054,986,937,2927,4745]","Sova,Viper,Sage,Reyna,Jett","Sova,Viper,Sage,Reyna,Jett",1588
54551,24836,"VCT Brazil 2022 - Stage 1 Challengers 1 - Group Stage","Bind",53,"Team Vikings",319,"Liberty",1,3,13,2,10,0,0,0,2,10,1,3,2,1,1,3,1,10,2,"standard","2022-02-12T00:00:00.000Z","[1159,13153,181,2894,2607]","[986,4745,2054,2927,937]","Raze,Viper,Sage,Skye,Astra","Breach,Raze,Sova,Skye,Astra",1588
54528,24828,"VCT North America 2022 - Stage 1 Challengers - Group Stage","Haven",388,"Sentinels",116,"NRG Esports",2,13,11,5,7,1,1,0,8,4,5,7,1,1,0,7,5,4,8,"standard","2022-02-12T00:00:00.000Z","[724,893,3033,1614,1485]","[1597,165,1232,1763,493]","Cypher,Sova,Jett,Skye,Astra","Sova,Jett,Astra,KAY/O,Chamber",1588
54727,24898,"VCT LATAM South 2022 - Stage 1 Challengers 1 - Group Stage","Haven",683,"9z Team",5305,"EBRO Gaming",2,13,11,7,5,0,0,0,6,6,7,5,2,1,1,5,7,6,6,"standard","2022-02-12T00:00:00.000Z","[3510,1376,855,3506,9905]","[3507,5831,4605,4061,4791]","Breach,Sova,Killjoy,Jett,Astra","Sova,Killjoy,Jett,Skye,Astra",1588
54726,24898,"VCT LATAM South 2022 - Stage 1 Challengers 1 - Group Stage","Ascent",683,"9z Team",5305,"EBRO Gaming",2,13,8,7,5,1,1,0,6,3,7,5,1,1,0,5,7,3,6,"standard","2022-02-12T00:00:00.000Z","[1376,855,3506,9905,3510]","[3507,5831,4605,4061,4791]","Sova,Killjoy,Jett,Astra,KAY/O","Sova,Killjoy,Jett,Skye,Astra",1588
54549,24835,"VCT Brazil 2022 - Stage 1 Challengers 1 - Group Stage","Split",580,"Gamelanders Blue",6344,"LOUD",1,7,13,6,6,1,1,0,6,6,1,7,1,1,0,7,1,6,6,"standard","2022-02-12T00:00:00.000Z","[739,622,6038,4747,1427]","[2895,4746,2294,6037,4748]","Cypher,Viper,Jett,Skye,Astra","Raze,Viper,Skye,Astra,Chamber",1588
54527,24828,"VCT North America 2022 - Stage 1 Challengers - Group Stage","Fracture",388,"Sentinels",116,"NRG Esports",1,10,13,3,9,1,0,1,3,9,7,4,1,0,1,4,7,9,3,"standard","2022-02-12T00:00:00.000Z","[893,1485,3033,1614,724]","[1597,493,165,1232,1763]","Breach,Viper,Jett,Astra,Chamber","Breach,Viper,Jett,Astra,Chamber",1588
54725,24898,"VCT LATAM South 2022 - Stage 1 Challengers 1 - Group Stage","Breeze",683,"9z Team",5305,"EBRO Gaming",2,7,13,4,8,0,0,0,3,5,4,8,2,1,1,8,4,5,3,"standard","2022-02-12T00:00:00.000Z","[9905,1376,855,3506,3510]","[5831,3507,4791,4605,4061]","Cypher,Sova,Viper,Jett,Skye","Cypher,Sova,Viper,Jett,Skye",1588
54548,24835,"VCT Brazil 2022 - Stage 1 Challengers 1 - Group Stage","Bind",580,"Gamelanders Blue",6344,"LOUD",1,9,13,5,7,0,0,0,5,7,4,6,2,1,1,6,4,7,5,"standard","2022-02-12T00:00:00.000Z","[622,739,6038,1427,4747]","[4748,2294,4746,2895,6037]","Sova,Viper,Jett,Astra,KAY/O","Raze,Sova,Viper,Skye,Astra",1588
54723,24897,"VCT LATAM South 2022 - Stage 1 Challengers 1 - Group Stage","Haven",976,"KRÜ Esports",1503,"Movistar Optix",2,13,0,12,0,2,1,1,1,0,12,0,0,0,0,0,12,0,1,"standard","2022-02-12T00:00:00.000Z","[4712,4710,1725,2532,3535]","[3411,4619,14764,14762,3409]","Cypher,Sova,Phoenix,Jett,Astra","Sova,Killjoy,Jett,Skye,Astra",1588
54084,24660,"VCT EMEA 2022 - Stage 1 Challengers - Group Stage","Bind",3540,"SuperMassive",2597,"Acend",2,4,13,4,8,1,0,1,0,5,4,8,1,0,1,8,4,5,0,"standard","2022-02-12T00:00:00.000Z","[9640,9642,2969,3725,3233]","[2391,3208,1334,732,691]","Raze,Sova,Viper,Skye,Astra","Raze,Viper,Brimstone,Sage,Skye",1588
54722,24897,"VCT LATAM South 2022 - Stage 1 Challengers 1 - Group Stage","Split",976,"KRÜ Esports",1503,"Movistar Optix",1,13,8,9,3,0,0,0,9,3,4,5,2,1,1,5,4,3,9,"standard","2022-02-12T00:00:00.000Z","[1725,4712,2532,4710,3535]","[14764,4619,3409,14762,3411]","Raze,Viper,Jett,Skye,Astra","Raze,Cypher,Viper,Skye,Astra",1588
54083,24660,"VCT EMEA 2022 - Stage 1 Challengers - Group Stage","Ascent",3540,"SuperMassive",2597,"Acend",1,12,14,8,4,2,1,1,8,5,4,9,0,0,0,9,4,5,8,"standard","2022-02-12T00:00:00.000Z","[9642,2969,3725,9640,3233]","[1334,3208,732,691,2391]","Sova,Killjoy,Sage,Jett,Astra","Sova,Killjoy,Jett,Astra,KAY/O",1588
54082,24659,"VCT EMEA 2022 - Stage 1 Challengers - Group Stage","Split",17,"FunPlus Phoenix",329,"BIG",1,13,11,5,7,0,0,0,5,7,8,4,2,1,1,4,8,7,5,"standard","2022-02-12T00:00:00.000Z","[1256,2225,3043,2335,2359]","[1538,3142,2326,360,4956]","Raze,Cypher,Sova,Viper,Astra","Cypher,Sage,Jett,Skye,Astra",1588
54081,24659,"VCT EMEA 2022 - Stage 1 Challengers - Group Stage","Haven",17,"FunPlus Phoenix",329,"BIG",1,13,8,7,5,0,0,0,7,5,6,3,2,1,1,3,6,5,7,"standard","2022-02-12T00:00:00.000Z","[2359,2225,3043,2335,1256]","[3142,360,2326,4956,1538]","Sova,Killjoy,Jett,Astra,KAY/O","Sova,Killjoy,Jett,Astra,KAY/O",1588
54080,24659,"VCT EMEA 2022 - Stage 1 Challengers - Group Stage","Bind",17,"FunPlus Phoenix",329,"BIG",2,7,13,4,8,1,1,0,3,5,4,8,1,1,0,8,4,5,3,"standard","2022-02-12T00:00:00.000Z","[1256,3043,2335,2225,2359]","[1538,3142,2326,360,4956]","Raze,Sova,Viper,Skye,Astra","Raze,Sova,Viper,Skye,Astra",1588
54525,24827,"VCT North America 2022 - Stage 1 Challengers - Group Stage","Icebox",1931,"Version1 (Inactive)",588,"Knights",1,13,2,10,2,2,1,1,10,2,3,0,0,0,0,0,3,2,10,"standard","2022-02-12T00:00:00.000Z","[3056,7025,3798,440,3352]","[2810,3894,3831,835,3340]","Sova,Killjoy,Viper,Sage,Jett","Sova,Killjoy,Viper,Sage,Jett",1588
54524,24827,"VCT North America 2022 - Stage 1 Challengers - Group Stage","Ascent",1931,"Version1 (Inactive)",588,"Knights",2,13,4,8,4,1,1,0,5,0,8,4,1,1,0,4,8,0,5,"standard","2022-02-12T00:00:00.000Z","[3056,7025,3352,3798,440]","[2810,3894,835,3340,3831]","Sova,Killjoy,Jett,Astra,KAY/O","Sova,Killjoy,Sage,Jett,Astra",1588
54522,24826,"VCT North America 2022 - Stage 1 Challengers - Group Stage","Breeze",141,"Cloud9",305,"100 Thieves",1,13,6,7,5,2,1,1,7,5,6,1,0,0,0,1,6,5,7,"standard","2022-02-11T00:00:00.000Z","[1961,4639,3599,13591,2213]","[588,355,923,763,10253]","Sova,Viper,Jett,KAY/O,Chamber","Cypher,Sova,Viper,Jett,Skye",1588
54521,24826,"VCT North America 2022 - Stage 1 Challengers - Group Stage","Split",141,"Cloud9",305,"100 Thieves",2,13,10,9,3,1,0,1,4,7,9,3,1,0,1,3,9,7,4,"standard","2022-02-11T00:00:00.000Z","[1961,13591,2213,4639,3599]","[763,588,355,10253,923]","Breach,Raze,Killjoy,Astra,Chamber","Raze,Cypher,Viper,Skye,Astra",1588
54079,24658,"VCT EMEA 2022 - Stage 1 Challengers - Group Stage","Split",194,"G2 Esports (Inactive)",1625,"FNATIC",1,8,13,6,6,2,1,1,6,6,2,7,0,0,0,7,2,6,6,"standard","2022-02-11T00:00:00.000Z","[1826,2377,2594,2769,2940]","[2937,154,2290,76,2011]","Raze,Cypher,Sage,Omen,Jett","Raze,Viper,Sage,Astra,KAY/O",1588
54078,24658,"VCT EMEA 2022 - Stage 1 Challengers - Group Stage","Ascent",194,"G2 Esports (Inactive)",1625,"FNATIC",1,13,11,3,9,1,0,1,3,9,10,2,1,0,1,2,10,9,3,"standard","2022-02-11T00:00:00.000Z","[1826,2377,2940,2769,2594]","[2290,154,2937,76,2011]","Sova,Killjoy,Jett,Astra,KAY/O","Sova,Killjoy,Jett,Astra,KAY/O",1588
54077,24658,"VCT EMEA 2022 - Stage 1 Challengers - Group Stage","Icebox",194,"G2 Esports (Inactive)",1625,"FNATIC",2,8,13,7,5,0,0,0,1,8,7,5,2,1,1,5,7,8,1,"standard","2022-02-11T00:00:00.000Z","[1826,2377,2769,2594,2940]","[2290,154,76,2011,2937]","Sova,Killjoy,Viper,Sage,Jett","Sova,Killjoy,Viper,Sage,Jett",1588
54075,24657,"VCT EMEA 2022 - Stage 1 Challengers - Group Stage","Breeze",224,"Team Liquid",255,"Gambit Esports",2,8,13,7,5,1,0,1,1,8,7,5,1,0,1,5,7,8,1,"standard","2022-02-11T00:00:00.000Z","[1403,17788,1690,2056,10211]","[1964,1081,3135,2528,274]","Sova,Viper,Skye,KAY/O,Chamber","Sova,Viper,Jett,Skye,Chamber",1588
54074,24657,"VCT EMEA 2022 - Stage 1 Challengers - Group Stage","Icebox",224,"Team Liquid",255,"Gambit Esports",2,9,13,3,9,0,0,0,6,4,3,9,2,1,1,9,3,4,6,"standard","2022-02-11T00:00:00.000Z","[2056,17788,1403,1690,10211]","[1964,274,1081,3135,2528]","Sova,Viper,Sage,Reyna,Chamber","Sova,Viper,Sage,Jett,KAY/O",1588
54777,24915,"VCT Korea 2022 - Stage 1 Challengers - Open Qualifier : Ro16","Split",1267,"Spear Gaming",5373,"On Sla2ers",1,7,13,4,8,0,0,0,4,8,3,5,2,1,1,5,3,8,4,"standard","2022-02-06T00:00:00.000Z","[15737,8076,15736,18850,6600]","[2151,2904,1075,1199,2009]","Raze,Viper,Skye,Astra,Chamber","Viper,Sage,Jett,Skye,Astra",1588
54826,24936,"VCT Korea 2022 - Stage 1 Challengers - Open Qualifier : Ro16","Breeze",6406,"CNJ Esports",6348,"Brimstone",1,6,13,2,10,1,0,1,2,10,4,3,1,0,1,3,4,10,2,"standard","2022-02-06T00:00:00.000Z","[5737,6692,18839,1008,18838]","[3186,2908,15725,2508,1810]","Sova,Viper,Reyna,Jett,Chamber","Sova,Viper,Jett,KAY/O,Chamber",1588
54776,24915,"VCT Korea 2022 - Stage 1 Challengers - Open Qualifier : Ro16","Haven",1267,"Spear Gaming",5373,"On Sla2ers",1,2,13,2,10,0,0,0,2,10,0,3,2,1,1,3,0,10,2,"standard","2022-02-06T00:00:00.000Z","[6600,15736,15737,8076,18850]","[2904,1199,2151,1075,2009]","Cypher,Sova,Jett,Skye,Astra","Breach,Sova,Killjoy,Jett,Astra",1588
54798,24924,"VCT Korea 2022 - Stage 1 Challengers - Open Qualifier : Ro16","Bind",3043,"GoNGo Prince",6368,"Team T5",2,12,14,6,6,2,1,1,6,7,6,7,0,0,0,7,6,7,6,"standard","2022-02-06T00:00:00.000Z","[12340,6702,2753,1823,15738]","[6595,6549,6546,8058,22791]","Sova,Jett,Skye,Astra,Chamber","Raze,Viper,Jett,Skye,Astra",1588
54825,24936,"VCT Korea 2022 - Stage 1 Challengers - Open Qualifier : Ro16","Bind",6406,"CNJ Esports",6348,"Brimstone",2,11,13,7,5,1,1,0,4,8,7,5,1,1,0,5,7,8,4,"standard","2022-02-06T00:00:00.000Z","[1008,5737,18838,18839,6692]","[2908,1810,3186,2508,15725]","Breach,Sova,Killjoy,Jett,Astra","Raze,Viper,Sage,Skye,Astra",1588
54797,24924,"VCT Korea 2022 - Stage 1 Challengers - Open Qualifier : Ro16","Haven",3043,"GoNGo Prince",6368,"Team T5",1,7,13,6,6,0,0,0,6,6,1,7,2,1,1,7,1,6,6,"standard","2022-02-06T00:00:00.000Z","[2753,12340,15738,6702,1823]","[6595,22791,6546,8058,6549]","Breach,Sova,Killjoy,Jett,Astra","Sova,Omen,Jett,KAY/O,Chamber",1588
54765,24911,"VCT Korea 2022 - Stage 1 Challengers - Open Qualifier : Ro16","Haven",6396,"Team GP",6360,"Desperado",2,6,13,5,7,0,0,0,1,6,5,7,2,1,1,7,5,6,1,"standard","2022-02-06T00:00:00.000Z","[15718,12284,745,679,22846]","[22699,6690,227,3523,18866]","Sova,Killjoy,Jett,Skye,Astra","Raze,Killjoy,Jett,Skye,Astra",1588
54809,24928,"VCT Korea 2022 - Stage 1 Challengers - Open Qualifier : Ro16","Haven",1515,"World Game Star",6348,"Brimstone",2,13,6,9,3,1,0,1,4,3,9,3,1,0,1,3,9,3,4,"standard","2022-02-06T00:00:00.000Z","[2687,293,2662,2650,3522]","[3186,2908,2508,15725,1810]","Breach,Sova,Killjoy,Jett,Astra","Breach,Jett,Skye,Astra,Chamber",1588
54764,24911,"VCT Korea 2022 - Stage 1 Challengers - Open Qualifier : Ro16","Ascent",6396,"Team GP",6360,"Desperado",1,8,13,4,8,1,0,1,4,8,4,5,1,0,1,5,4,8,4,"standard","2022-02-06T00:00:00.000Z","[15718,12284,745,679,22846]","[227,6690,22699,18866,3523]","Sova,Killjoy,Jett,Skye,Astra","Sova,Killjoy,Jett,Astra,KAY/O",1588
54786,24918,"VCT Korea 2022 - Stage 1 Challengers - Open Qualifier : Ro16","Breeze",3043,"GoNGo Prince",6366,"Maru Gaming",2,10,13,4,8,0,0,0,6,5,4,8,2,1,1,8,4,5,6,"standard","2022-02-06T00:00:00.000Z","[6619,1823,2753,6702,15738]","[6719,6740,6738,8382,4229]","Sova,Viper,Reyna,Jett,Chamber","Sova,Viper,Sage,Jett,Chamber",1588
54775,24914,"VCT Korea 2022 - Stage 1 Challengers - Open Qualifier : Ro16","Split",1267,"Spear Gaming",6413,"Veronica7",2,13,8,7,5,0,0,0,6,3,7,5,2,1,1,5,7,3,6,"standard","2022-02-06T00:00:00.000Z","[15737,8076,15736,18850,6600]","[15727,10183,10180,6623,10178]","Raze,Viper,Skye,Astra,Chamber","Breach,Raze,Sage,Astra,Chamber",1588
54808,24928,"VCT Korea 2022 - Stage 1 Challengers - Open Qualifier : Ro16","Breeze",1515,"World Game Star",6348,"Brimstone",2,13,7,7,5,1,1,0,6,2,7,5,1,1,0,5,7,2,6,"standard","2022-02-06T00:00:00.000Z","[293,3522,2650,2687,2662]","[3186,2908,15725,2508,1810]","Sova,Viper,Jett,KAY/O,Chamber","Sova,Viper,Jett,KAY/O,Chamber",1588
54794,24922,"VCT Korea 2022 - Stage 1 Challengers - Open Qualifier : Ro16","Breeze",6368,"Team T5",6388,"Pentagon",2,13,11,8,4,0,0,0,5,7,8,4,2,1,1,4,8,7,5,"standard","2022-02-06T00:00:00.000Z","[6595,6549,22791,6546,8058]","[6599,1137,22814,10181,6744]","Sova,Viper,Sage,Jett,KAY/O","Viper,Jett,Skye,KAY/O,Chamber",1588
54771,24913,"VCT Korea 2022 - Stage 1 Challengers - Open Qualifier : Ro16","Icebox",997,"DAMWON Gaming",5373,"On Sla2ers",2,13,9,10,2,1,0,1,3,7,10,2,1,0,1,2,10,7,3,"standard","2022-02-06T00:00:00.000Z","[2368,2762,2240,4811,1406]","[1075,2009,2151,2904,1199]","Sova,Viper,Reyna,Jett,Chamber","Sova,Viper,Reyna,Jett,Chamber",1588
54823,24935,"VCT Korea 2022 - Stage 1 Challengers - Open Qualifier : Ro16","Haven",6406,"CNJ Esports",6394,"Next eSports",1,13,10,6,6,1,1,0,6,6,7,4,1,1,0,4,7,6,6,"standard","2022-02-06T00:00:00.000Z","[5737,18838,18839,1008,6692]","[22840,6704,22841,22839,22842]","Breach,Killjoy,Jett,Skye,Astra","Breach,Killjoy,Jett,Skye,Astra",1588
54756,24908,"VCT Korea 2022 - Stage 1 Challengers - Open Qualifier : Ro16","Haven",286,"DRX",6396,"Team GP",1,13,5,8,4,2,1,1,8,4,5,1,0,0,0,1,5,4,8,"standard","2022-02-06T00:00:00.000Z","[582,1251,1550,814,452]","[15718,12284,745,679,22846]","Breach,Killjoy,Jett,Skye,Astra","Sova,Killjoy,Jett,Skye,Astra",1588
54762,24910,"VCT Korea 2022 - Stage 1 Challengers - Open Qualifier : Ro16","Bind",6360,"Desperado",6359,"VPZ",1,13,7,8,4,1,1,0,8,4,5,3,1,1,0,3,5,4,8,"standard","2022-02-06T00:00:00.000Z","[3523,22699,6690,227,18866]","[22697,6695,22696,15739,22698]","Breach,Raze,Sova,Jett,Astra","Killjoy,Reyna,Jett,Skye,Astra",1588
54793,24922,"VCT Korea 2022 - Stage 1 Challengers - Open Qualifier : Ro16","Bind",6368,"Team T5",6388,"Pentagon",1,13,1,11,1,2,1,1,11,1,2,0,0,0,0,0,2,1,11,"standard","2022-02-06T00:00:00.000Z","[6595,6549,6546,8058,22791]","[1137,6744,6599,22814,10181]","Raze,Viper,Jett,Skye,Astra","Raze,Cypher,Sova,Skye,Astra",1588
54785,24918,"VCT Korea 2022 - Stage 1 Challengers - Open Qualifier : Ro16","Fracture",3043,"GoNGo Prince",6366,"Maru Gaming",1,6,13,3,9,0,0,0,3,9,3,4,2,1,1,4,3,9,3,"standard","2022-02-06T00:00:00.000Z","[2753,15738,1823,6702,6619]","[6738,8382,6740,6719,4229]","Breach,Raze,Viper,Jett,Astra","Breach,Jett,Astra,KAY/O,Chamber",1588
54774,24914,"VCT Korea 2022 - Stage 1 Challengers - Open Qualifier : Ro16","Fracture",1267,"Spear Gaming",6413,"Veronica7",2,13,6,7,5,1,1,0,6,1,7,5,1,1,0,5,7,1,6,"standard","2022-02-06T00:00:00.000Z","[15736,8076,15737,6600,18850]","[15727,10183,10178,10180,6623]","Breach,Viper,Jett,Astra,KAY/O","Breach,Raze,Cypher,Sage,Astra",1588
54822,24935,"VCT Korea 2022 - Stage 1 Challengers - Open Qualifier : Ro16","Breeze",6406,"CNJ Esports",6394,"Next eSports",1,13,6,7,5,2,1,1,7,5,6,1,0,0,0,1,6,5,7,"standard","2022-02-06T00:00:00.000Z","[5737,6692,18839,1008,18838]","[22839,22842,15380,6704,22841]","Sova,Viper,Reyna,Jett,Chamber","Sova,Viper,Jett,KAY/O,Chamber",1588
54770,24913,"VCT Korea 2022 - Stage 1 Challengers - Open Qualifier : Ro16","Bind",997,"DAMWON Gaming",5373,"On Sla2ers",2,13,7,6,6,2,1,1,7,1,6,6,0,0,0,6,6,1,7,"standard","2022-02-06T00:00:00.000Z","[4811,1406,2240,2368,2762]","[2151,1075,2904,1199,2009]","Raze,Viper,Sage,Skye,Astra","Viper,Sage,Jett,Skye,Astra",1588
54807,24928,"VCT Korea 2022 - Stage 1 Challengers - Open Qualifier : Ro16","Split",1515,"World Game Star",6348,"Brimstone",1,10,13,8,4,1,1,0,8,4,2,9,1,1,0,9,2,4,8,"standard","2022-02-06T00:00:00.000Z","[2687,2662,293,2650,3522]","[2908,1810,3186,15725,2508]","Breach,Killjoy,Sage,Jett,Astra","Raze,Viper,Sage,Astra,KAY/O",1588
54755,24908,"VCT Korea 2022 - Stage 1 Challengers - Open Qualifier : Ro16","Breeze",286,"DRX",6396,"Team GP",1,13,3,9,3,1,0,1,9,3,4,0,1,0,1,0,4,3,9,"standard","2022-02-06T00:00:00.000Z","[1251,814,452,1550,582]","[15718,22846,745,12284,679]","Cypher,Sova,Viper,Jett,Skye","Sova,Viper,Jett,KAY/O,Chamber",1588
54761,24910,"VCT Korea 2022 - Stage 1 Challengers - Open Qualifier : Ro16","Ascent",6360,"Desperado",6359,"VPZ",2,13,5,8,4,2,1,1,5,1,8,4,0,0,0,4,8,1,5,"standard","2022-02-06T00:00:00.000Z","[227,6690,22699,18866,3523]","[15739,22697,6695,22696,22698]","Sova,Killjoy,Jett,Astra,KAY/O","Sova,Killjoy,Reyna,Jett,Astra",1588
54773,24914,"VCT Korea 2022 - Stage 1 Challengers - Open Qualifier : Ro16","Bind",1267,"Spear Gaming",6413,"Veronica7",1,9,13,6,6,1,1,0,6,6,3,7,1,1,0,7,3,6,6,"standard","2022-02-06T00:00:00.000Z","[15736,8076,15737,18850,6600]","[15727,10183,10180,6623,10178]","Sova,Viper,Jett,Skye,Astra","Breach,Raze,Skye,Astra,Chamber",1588
54784,24917,"VCT Korea 2022 - Stage 1 Challengers - Open Qualifier : Ro16","Split",3043,"GoNGo Prince",6388,"Pentagon",2,14,12,3,9,0,0,0,10,3,4,9,2,1,1,9,4,3,10,"standard","2022-02-06T00:00:00.000Z","[15738,2753,6702,6619,1823]","[6599,1137,22814,10181,6744]","Viper,Sage,Jett,Skye,Astra","Viper,Jett,Skye,Astra,Chamber",1588
54801,24925,"VCT Korea 2022 - Stage 1 Challengers - Open Qualifier : Ro16","Icebox",1515,"World Game Star",6394,"Next eSports",2,13,4,10,2,1,0,1,3,2,10,2,1,0,1,2,10,2,3,"standard","2022-02-06T00:00:00.000Z","[293,3522,2687,2650,2662]","[22840,6704,15380,22839,22841]","Sova,Viper,Sage,Jett,Chamber","Sova,Viper,Reyna,Omen,Chamber",1588
54759,24909,"VCT Korea 2022 - Stage 1 Challengers - Open Qualifier : Ro16","Bind",6396,"Team GP",6360,"Desperado",2,13,10,9,3,1,0,1,4,7,9,3,1,0,1,3,9,7,4,"standard","2022-02-06T00:00:00.000Z","[679,15718,12284,745,22846]","[227,6690,22699,3523,18866]","Raze,Sova,Killjoy,Jett,Astra","Raze,Sova,Viper,Skye,Astra",1588
54820,24934,"VCT Korea 2022 - Stage 1 Challengers - Open Qualifier : Ro16","Ascent",6406,"CNJ Esports",6348,"Brimstone",1,6,13,3,9,2,1,1,3,9,3,4,0,0,0,4,3,9,3,"standard","2022-02-06T00:00:00.000Z","[5737,18838,18839,6692,1008]","[3186,1810,2908,15725,2508]","Sova,Killjoy,Jett,Astra,KAY/O","Sova,Killjoy,Jett,Astra,KAY/O",1588
54780,24916,"VCT Korea 2022 - Stage 1 Challengers - Open Qualifier : Ro16","Ascent",5373,"On Sla2ers",6413,"Veronica7",2,13,3,10,2,2,1,1,3,1,10,2,0,0,0,2,10,1,3,"standard","2022-02-06T00:00:00.000Z","[2151,1199,1075,2009,2904]","[15727,10178,10183,10180,6623]","Cypher,Sova,Jett,Astra,KAY/O","Sova,Killjoy,Jett,Skye,Astra",1588
54768,24912,"VCT Korea 2022 - Stage 1 Challengers - Open Qualifier : Ro16","Split",997,"DAMWON Gaming",1267,"Spear Gaming",2,13,6,9,3,0,0,0,4,3,9,3,2,1,1,3,9,3,4,"standard","2022-02-06T00:00:00.000Z","[1406,2368,2240,4811,2762]","[15737,8076,15736,18850,6600]","Viper,Sage,Reyna,Jett,Astra","Raze,Viper,Skye,Astra,Chamber",1588
54753,24907,"VCT Korea 2022 - Stage 1 Challengers - Open Qualifier : Ro16","Split",286,"DRX",6359,"VPZ",1,13,8,6,6,2,1,1,6,6,7,2,0,0,0,2,7,6,6,"standard","2022-02-06T00:00:00.000Z","[452,814,1550,582,1251]","[22697,22696,6695,22698,15739]","Viper,Sage,Jett,Skye,Astra","Breach,Raze,Reyna,Astra,Chamber",1588
54791,24921,"VCT Korea 2022 - Stage 1 Challengers - Open Qualifier : Ro16","Split",6368,"Team T5",6366,"Maru Gaming",1,7,13,5,7,0,0,0,5,7,2,6,2,1,1,6,2,7,5,"standard","2022-02-06T00:00:00.000Z","[6595,6549,6546,22791,8058]","[6719,8382,6738,6740,4229]","Raze,Sage,Jett,Astra,KAY/O","Viper,Jett,Skye,Astra,Chamber",1588
54783,24917,"VCT Korea 2022 - Stage 1 Challengers - Open Qualifier : Ro16","Haven",3043,"GoNGo Prince",6388,"Pentagon",2,14,12,5,7,1,0,1,8,5,6,7,1,0,1,7,6,5,8,"standard","2022-02-06T00:00:00.000Z","[2753,15738,6702,6619,1823]","[22814,1137,6599,10181,6744]","Breach,Killjoy,Jett,Skye,Astra","Breach,Jett,Skye,Astra,Chamber",1588
54779,24916,"VCT Korea 2022 - Stage 1 Challengers - Open Qualifier : Ro16","Haven",5373,"On Sla2ers",6413,"Veronica7",2,13,6,10,2,1,0,1,3,4,10,2,1,0,1,2,10,4,3,"standard","2022-02-06T00:00:00.000Z","[2904,1199,2151,1075,2009]","[15727,10178,10183,10180,6623]","Breach,Sova,Killjoy,Jett,Astra","Breach,Cypher,Jett,Skye,Astra",1588
54752,24907,"VCT Korea 2022 - Stage 1 Challengers - Open Qualifier : Ro16","Haven",286,"DRX",6359,"VPZ",1,13,2,10,2,2,1,1,10,2,3,0,0,0,0,0,3,2,10,"standard","2022-02-06T00:00:00.000Z","[582,1251,1550,814,452]","[15739,22697,6695,22696,22698]","Breach,Killjoy,Jett,Skye,Astra","Sova,Killjoy,Reyna,Jett,Astra",1588
54767,24912,"VCT Korea 2022 - Stage 1 Challengers - Open Qualifier : Ro16","Fracture",997,"DAMWON Gaming",1267,"Spear Gaming",2,13,4,10,2,2,1,1,3,2,10,2,0,0,0,2,10,2,3,"standard","2022-02-06T00:00:00.000Z","[2240,2368,1406,4811,2762]","[15736,8076,15737,6600,18850]","Breach,Cypher,Viper,Jett,Astra","Breach,Viper,Jett,Astra,KAY/O",1588
54819,24934,"VCT Korea 2022 - Stage 1 Challengers - Open Qualifier : Ro16","Breeze",6406,"CNJ Esports",6348,"Brimstone",2,9,13,6,6,1,0,1,3,7,6,6,1,0,1,6,6,7,3,"standard","2022-02-06T00:00:00.000Z","[5737,6692,18839,1008,18838]","[3186,2908,15725,2508,1810]","Sova,Viper,Reyna,Jett,Chamber","Sova,Viper,Jett,KAY/O,Chamber",1588
54800,24925,"VCT Korea 2022 - Stage 1 Challengers - Open Qualifier : Ro16","Bind",1515,"World Game Star",6394,"Next eSports",1,13,10,6,6,0,0,0,6,6,7,4,2,1,1,4,7,6,6,"standard","2022-02-06T00:00:00.000Z","[2662,2687,293,2650,3522]","[22840,6704,22841,22839,22842]","Breach,Raze,Sova,Jett,Astra","Breach,Raze,Jett,Skye,Astra",1588
54790,24921,"VCT Korea 2022 - Stage 1 Challengers - Open Qualifier : Ro16","Breeze",6368,"Team T5",6366,"Maru Gaming",1,3,13,3,9,0,0,0,3,9,0,4,2,1,1,4,0,9,3,"standard","2022-02-06T00:00:00.000Z","[6595,6549,22791,6546,8058]","[6719,6740,6738,8382,4229]","Sova,Viper,Sage,Jett,KAY/O","Sova,Viper,Sage,Jett,Chamber",1588
54782,24917,"VCT Korea 2022 - Stage 1 Challengers - Open Qualifier : Ro16","Breeze",3043,"GoNGo Prince",6388,"Pentagon",1,4,13,3,9,1,0,1,3,9,1,4,1,0,1,4,1,9,3,"standard","2022-02-06T00:00:00.000Z","[15738,6619,1823,6702,2753]","[6599,1137,22814,10181,6744]","Cypher,Sova,Viper,Jett,KAY/O","Viper,Jett,Skye,KAY/O,Chamber",1588
54758,24909,"VCT Korea 2022 - Stage 1 Challengers - Open Qualifier : Ro16","Haven",6396,"Team GP",6360,"Desperado",1,13,9,6,6,1,0,1,6,6,7,3,1,0,1,3,7,6,6,"standard","2022-02-06T00:00:00.000Z","[15718,12284,745,679,22846]","[227,6690,19177,3523,18866]","Sova,Killjoy,Jett,Skye,Astra","Breach,Killjoy,Jett,Skye,Astra",1588